Date,Credit/Debit,Transaction Name,Balance,Category
4/7/2024,-5,LAKESIDE ENTERPRISES UNIVERSITY OFAU Card xx4604,1234.46,Eating out
4/7/2024,-17.71,LUCA CURRIE PTY LTD WOOLLOONGABBA QL AUS Card xx4604 Value Date: 02/07/2024,1239.46,Eating out
3/7/2024,-22.95,DBS*Fitness Cartel Asp Aspley QL AUS Card xx4604 Value Date: 01/07/2024,1257.17,Entertainment
3/7/2024,-15,ANGELIKA FILM CENTRE WOOLLOONGABBA QL AUS Card xx4604 Value Date: 30/06/2024,1280.12,Entertainment
3/7/2024,-6.64,TCC Everton Hills Everton Hills QL AUS Card xx4604 Value Date: 30/06/2024,1295.12,Eating out
3/7/2024,-1,LITTLE RED DUMPLING WOOLLOONGABBA QL AUS Card xx4604 Value Date: 30/06/2024,1301.76,Food
3/7/2024,-4,LITTLE RED DUMPLING WOOLLOONGABBA QL AUS Card xx4604 Value Date: 30/06/2024,1302.76,Food
3/7/2024,-6.2,FOSTER & BLACK P/L CHERMSIDE QL AUS Card xx4604 Value Date: 29/06/2024,1306.76,Eating out
3/7/2024,-45,THE BARBER ROOM BRISBANE AUS Card xx4604 Value Date: 01/07/2024,1312.96,Entertainment
3/7/2024,-3.15,DRAKE SUPERMARKETS M MCDOWALL AUS Card xx4604 Value Date: 30/06/2024,1357.96,Food
2/7/2024,-10,Sportsbet,1361.11,Entertainment
2/7/2024,-4.27,SQ *HEY MR.DUTTON PARK Dutton Park QL AUS Card xx4604 Value Date: 28/06/2024,1371.11,Eating out
2/7/2024,-2.9,WOOLWORTHS 2678 ASPLEY AU AUS Card xx4604 Value Date: 28/06/2024,1375.38,Food
2/7/2024,-30,KMART 1218KMART 1218 ASPLEY AU AUS Card xx4604 Value Date: 28/06/2024,1378.28,Eating out
2/7/2024,-17.69,ZLR*sunshine kebab Aa Aspley AU AUS Card xx4604 Value Date: 28/06/2024,1408.28,Food
2/7/2024,-5.8,COLES 4547COLES 4547 CHERMSIDE AU AUS Card xx4604 Value Date: 29/06/2024,1425.97,Eating out
2/7/2024,-12.14,SQ *MELT BROTHERS CHER Chermside QL AUS Card xx4604 Value Date: 29/06/2024,1431.77,Eating out
2/7/2024,-6.7,MEKONG CHERMSIDE Chermside QL AUS Card xx4604 Value Date: 29/06/2024,1443.91,Food
2/7/2024,-22.9,CHERMSIDE FISH MARKET CHERMSIDE QL AUS Card xx4604 Value Date: 29/06/2024,1450.61,Food
2/7/2024,-11.61,CHERMSIDE BUTCHER CHERMSIDE QL AUS Card xx4604 Value Date: 29/06/2024,1473.51,Food
2/7/2024,-8.25,WOOLWORTHS 2865 WOOLLOONGABBA AU AUS Card xx4604 Value Date: 30/06/2024,1485.12,Eating out
2/7/2024,-27.13,LITTLE RED DUMPLING GA ROCHEDALE SOU QL AUS Card xx4604 Value Date: 30/06/2024,1493.37,Eating out
2/7/2024,-5.55,SQ *BRISBEAN COFFEE Alderley AU,1520.5,Entertainment
1/7/2024,-15.86,SQ *HEY MR.DUTTON PARK Dutton Park AU,1526.05,Eating out
30/6/2024,-10,Le Boulangerie Amour WoolloongabbaAU,1541.91,Food
29/6/2024,-97.49,AMPOL CHERMSIDE 11885F CHERMSIDE AUS Card xx4604 Value Date: 27/06/2024,1551.91,Travel
28/6/2024,-4.6,ALH VENUES 8098 MITCHELTON AU AUS Card xx4604 Value Date: 26/06/2024,1649.4,Eating out
28/6/2024,-47.13,COLES 4547COLES 4547 CHERMSIDE AU AUS Card xx4604 Value Date: 26/06/2024,1654,Food
28/6/2024,-4.6,ALH VENUES 8098 MITCHELTON AU AUS Card xx4604 Value Date: 26/06/2024,1701.13,Travel
28/6/2024,-20.48,CellOPark Australia Matraville NS AUS Card xx4604 Value Date: 26/06/2024,1705.73,Food
27/6/2024,-6.71,Direct Debit 617704 PAYPAL AUSTRALIA 1035282845122,1726.21,Entertainment
27/6/2024,726,Salary Q GROUP 25062024VAND,1732.92,Food
27/6/2024,-101.19,WWW.GFPEVENTS.COM.AU,1006.92,Eating out
27/6/2024,-1.69,Transfer to other Bank CommBank app heres a cigarette,1108.11,Entertainment
27/6/2024,-6.5,MUFFIN BREAK CHERMS CHERMSIDE AU,1109.8,Eating out
27/6/2024,-5.59,SQ *HEY MR.DUTTON PARK Dutton Park QL AUS Card xx4604 Value Date: 25/06/2024,1116.3,Eating out
27/6/2024,-14.3,SUSHI HUB ALBERT ST BRISBANE CITY QL AUS Card xx4604 Value Date: 24/06/2024,1121.89,Eating out
27/6/2024,-14.9,VIETS ROLL STREET FOOD WOOLLOONGABBA AUS Card xx4604 Value Date: 25/06/2024,1136.19,Food
26/6/2024,-1.15,MCDONALDS BROOKSIDE MITCHELTON QLDAU,1151.09,Food
26/6/2024,-27.93,Transfer to other Bank CommBank app food,1152.24,Eating out
26/6/2024,-12.3,COLES 4430 MITCHELTON AU,1180.17,Food
26/6/2024,-5.66,SQ *CAFFE CHERRY BEANS Chermside AU,1192.47,Eating out
26/6/2024,-22.95,DBS*Fitness Cartel Asp Aspley QL AUS Card xx4604 Value Date: 24/06/2024,1198.13,Entertainment
26/6/2024,-12.25,YO CHI ALBERT ST BRISBANE ADEL QL AUS Card xx4604 Value Date: 21/06/2024,1221.08,Eating out
26/6/2024,-5.55,SQ *BRISBEAN COFFEE Alderley QL AUS Card xx4604 Value Date: 25/06/2024,1233.33,Eating out
26/6/2024,-10,TRANSLINK SMARTTICKET QLD AUS Card xx4604 Value Date: 25/06/2024,1238.88,Food
25/6/2024,-34.5,chicken of rock Fortitude ValAU,1248.88,Food
25/6/2024,-5.59,SQ *HEY MR.DUTTON PARK Dutton Park AU,1283.38,Eating out
25/6/2024,-32,JB HI FI CHERMSIDE CHERMSIDE QL AUS Card xx4604 Value Date: 20/06/2024,1288.97,Food
25/6/2024,-30,TRANSLINK BRISBANE AUS Card xx4604 Value Date: 24/06/2024,1320.97,Food
24/6/2024,-17.02,Direct Debit 617704 PAYPAL AUSTRALIA 1035191940219,1350.97,Food
24/6/2024,-12.75,COLES 4334 BRISBANE AU,1367.99,Entertainment
24/6/2024,-11,LushAustraliaPOS Brisbane AU,1380.74,Utilities
24/6/2024,-23.38,SQ *HEY MR.DUTTON PARK Dutton Park AU,1391.74,Eating out
23/6/2024,-5,ZARRAFFAS COFFEE GROVELY KEPERRA QLD AU Card xx4604,1415.12,Food
23/6/2024,-88,Transfer To Christian Carbone CommBank App Happy birthday mate! -- ...,1420.12,Food
22/6/2024,-5.6,MUFFIN BREAK CHERMS CHERMSIDE AU,1508.12,Entertainment
22/6/2024,-5,COLES 4547COLES 4547 CHERMSIDE AU AUS Card xx4604 Value Date: 20/06/2024,1513.72,Travel
22/6/2024,-23.5,SMP*Cafe 63 Chermside Chermside AU AUS Card xx4604 Value Date: 20/06/2024,1518.72,Travel
21/6/2024,-10,KARAOKE CITY BRISBANE AU Card xx4604,1542.22,Travel
21/6/2024,-15.5,VIETS ROLL STREET FOOD WOOLLOONGABBAAU,1552.22,Eating out
21/6/2024,-5.55,SQ *BRISBEAN COFFEE Alderley AU,1567.72,Eating out
21/6/2024,-21.32,RODE MEATS STAFFORD HEIG QL AUS Card xx4604 Value Date: 19/06/2024,1573.27,Food
21/6/2024,-25,MED*ALDIMobile CHATSWOOD AU AUS Card xx4604 Value Date: 19/06/2024,1594.59,Eating out
21/6/2024,-18,KRUSTY KRAB SEAFOODS MCDOWALL QL AUS Card xx4604 Value Date: 18/06/2024,1619.59,Eating out
21/6/2024,-6.7,ZARRAFFAS COFFEE GROV KEPERRA AUS Card xx4604 Value Date: 19/06/2024,1637.59,Food
20/6/2024,726,Salary Q GROUP 18062024VAND,1644.29,Eating out
20/6/2024,-23.8,CHERMSIDE FISH MARKET CHERMSIDE QLD AU,918.29,Food
19/6/2024,-9.16,SQ *SOUFFLE JAPANCAKES Chermside QL AUS Card xx4604 Value Date: 17/06/2024,942.09,Food
19/6/2024,-22.95,DBS*Fitness Cartel Asp Aspley QL AUS Card xx4604 Value Date: 17/06/2024,951.25,Eating out
19/6/2024,-113.93,7-ELEVEN 4098 ASPLEY QL AUS Card xx4604 Value Date: 16/06/2024,974.2,Food
19/6/2024,-7.98,GZ BLUE PTY LTD BRISBANE CITY AUS Card xx4604 Value Date: 14/06/2024,1088.13,Food
18/6/2024,-5.5,CHEZ NOUS CAFE BRISBANE QL AUS Card xx4604 Value Date: 14/06/2024,1096.11,Food
18/6/2024,-5.1,8TH MCDOWALL CAFE PTY MCDOWALL AU AUS Card xx4604 Value Date: 16/06/2024,1101.61,Eating out
18/6/2024,-5.55,SQ *BRISBEAN COFFEE Alderley AU,1106.71,Food
17/6/2024,-4.98,SQ *HEY MR.DUTTON PARK Dutton Park AU,1112.26,Entertainment
15/6/2024,-38.55,COLES 4547 CHERMSIDE AU AUS Card xx4604 Value Date: 13/06/2024,1117.24,Eating out
14/6/2024,-7,99 Bikes Brisbane CBD Brisbane AU,1155.79,Food
14/6/2024,-16.15,MEKONG 2 CITY PTY LTD Brisbane AU,1162.79,Eating out
14/6/2024,-24.88,OFFICEWORKS 0415 ASPLEY AU AUS Card xx4604 Value Date: 12/06/2024,1178.94,Food
14/6/2024,-11.99,GOOGLE*PLAY BOOKS G.CO/HELPPAY# AU AUS Card xx4604 Value Date: 12/06/2024,1203.82,Eating out
14/6/2024,-5.3,STARBUCKS COFFEE D03 FORTITUDE VAL QL AUS Card xx4604 Value Date: 12/06/2024,1215.81,Eating out
14/6/2024,-18.5,GOLD LAYERS KANGAROO POIN QL AUS Card xx4604 Value Date: 12/06/2024,1221.11,Entertainment
14/6/2024,-5.56,COFFEE AT THE KOMBI SOUTH BRISBAN AUS Card xx4604 Value Date: 12/06/2024,1239.61,Food
13/6/2024,507,Salary Q GROUP 11062024VAND,1245.17,Food
13/6/2024,-5.6,MUFFIN BREAK CHERMS CHERMSIDE AU,738.17,Eating out
13/6/2024,-14.97,TEMU.COM PARRAMATTA NS AUS Card xx4604 Value Date: 11/06/2024,743.77,Food
13/6/2024,-30,TRANSLINK BRISBANE AUS Card xx4604 Value Date: 12/06/2024,758.74,Eating out
12/6/2024,-14,8TH MCDOWALL CAFE PTY MCDOWALL AU AUS Card xx4604 Value Date: 10/06/2024,788.74,Food
12/6/2024,-22.95,DBS*Fitness Cartel Asp Aspley QL AUS Card xx4604 Value Date: 10/06/2024,802.74,Food
12/6/2024,-7.86,YO GET IT QLD CHERMSIDE QL AUS Card xx4604 Value Date: 09/06/2024,825.69,Food
11/6/2024,-4.5,Krispy Kreme Albert St 131 Queen StrAU,833.55,Utilities
11/6/2024,-21,ZAIHOU PTY LTD BRISBANE CITYAU Card xx4604,838.05,Travel
11/6/2024,-12,CASSIS AUSTRALIA PTY L WOOLLOONGABBA AU AUS Card xx4604 Value Date: 07/06/2024,859.05,Food
11/6/2024,-17.5,KRUSTY KRAB SEAFOODS MCDOWALL QL AUS Card xx4604 Value Date: 06/06/2024,871.05,Eating out
11/6/2024,-39.75,COLES EXPRESS 1860 WINDSOR AU AUS Card xx4604 Value Date: 09/06/2024,888.55,Eating out
11/6/2024,-15.6,CantaloupeSystemsAustr Albion QL AUS Card xx4604 Value Date: 09/06/2024,928.3,Food
11/6/2024,-4,CantaloupeSystemsAustr Albion QL AUS Card xx4604 Value Date: 09/06/2024,943.9,Travel
11/6/2024,-5.55,SQ *BRISBEAN COFFEE Alderley AU,947.9,Eating out
10/6/2024,-23.9,Nandos_AU_Pinpads Newmarket AU,953.45,Utilities
10/6/2024,-5.94,UQU Bakery St Lucia AU,977.35,Eating out
10/6/2024,-5.08,UQU Bakery St Lucia AU,983.29,Food
10/6/2024,-14.14,DRAKE SUPERMARKETS M MCDOWALL AU,988.37,Entertainment
9/6/2024,-24.2,GYG WF Chermside Chermside AU,1002.51,Travel
9/6/2024,-6.65,Chatime UQ St Lucia St Lucia AU,1026.71,Entertainment
9/6/2024,-18.5,Espresso Garage South BrisbanAU,1033.36,Eating out
9/6/2024,-5.56,COFFEE AT THE KOMBI SOUTH BRISBAN QLD AU,1051.86,Eating out
8/6/2024,-26.24,SQ *SAINT LUCY CAFFE St lucia AU,1057.42,Eating out
8/6/2024,-5.3,BAR MERLO UQ BRISBANE AU,1083.66,Food
8/6/2024,-3.7,CantaloupeSystemsAustr Albion QL AUS Card xx4604 Value Date: 06/06/2024,1088.96,Eating out
7/6/2024,-90.99,URBAN THAI MASSAGE & SPA BRISBANE QLD AU,1092.66,Food
7/6/2024,-5.59,SQ *HEY MR.DUTTON PARK Dutton Park AU,1183.65,Entertainment
7/6/2024,-6.56,SQ *BRISBEAN COFFEE Alderley AU,1189.24,Food
7/6/2024,-4.4,ALH VENUES 8098 MITCHELTON AU AUS Card xx4604 Value Date: 05/06/2024,1195.8,Eating out
7/6/2024,-4.2,ALH VENUES 8098 MITCHELTON AU AUS Card xx4604 Value Date: 05/06/2024,1200.2,Travel
7/6/2024,-4.58,KENKO SUSHI HOUSE ST LUCIA AU AUS Card xx4604 Value Date: 05/06/2024,1204.4,Eating out
7/6/2024,-11.2,BAR MERLO UQ BRISBANE QL AUS Card xx4604 Value Date: 05/06/2024,1208.98,Food
7/6/2024,-13,Guzman y Gomez St Lucia QL AUS Card xx4604 Value Date: 05/06/2024,1220.18,Travel
7/6/2024,-36.62,WWW.ALHGROUP.COM* ME&U SYDNEY NS AUS Card xx4604 Value Date: 05/06/2024,1233.18,Food
6/6/2024,-19.17,DRAKE SUPERMARKETS M MCDOWALL AU,1269.8,Eating out
6/6/2024,-1,KRUSTY KRAB SEAFOODS MCDOWALL QLD AU,1288.97,Travel
6/6/2024,-5.1,SQ *SMOKIN JOES ESPRES Everton Park AU,1289.97,Eating out
6/6/2024,-14.6,TCC Everton Hills Everton Hills QL AUS Card xx4604 Value Date: 03/06/2024,1295.07,Food
6/6/2024,-4.74,OFFICEWORKS 0415 ASPLEY AU AUS Card xx4604 Value Date: 04/06/2024,1309.67,Eating out
5/6/2024,-17,UQ SPORT LTD ST LUCIA AU,1314.41,Entertainment
5/6/2024,-22.95,DBS*Fitness Cartel Asp Aspley QL AUS Card xx4604 Value Date: 03/06/2024,1331.41,Food
5/6/2024,-6,ZARRAFFAS COFFEE GROV KEPERRA AUS Card xx4604 Value Date: 02/06/2024,1354.36,Eating out
4/6/2024,-6.45,MCDONALDS DT 0306 KEPERRA QLDAU,1360.36,Eating out
4/6/2024,-6,ZARRAFFAS COFFEE GROVELY KEPERRA QLD AU Card xx4604,1366.81,Eating out
4/6/2024,-6.64,TCC Everton Hills Everton Hills QL AUS Card xx4604 Value Date: 30/05/2024,1372.81,Entertainment
4/6/2024,-53.2,7 ELEVEN 4229 EVERTON HILLS QL AUS Card xx4604 Value Date: 01/06/2024,1379.45,Eating out
4/6/2024,-14.6,TCC Everton Hills Everton Hills QL AUS Card xx4604 Value Date: 01/06/2024,1432.65,Travel
1/6/2024,-38.88,Transfer to xx6073 CommBank app,1447.25,Food
1/6/2024,38.88,Transfer from xx3679 CommBank app,1486.13,Eating out
31/5/2024,-21580,Transfer to xx6073 NetBank,1447.25,Eating out
31/5/2024,21579.36,Transfer from xx3679 NetBank,23027.25,Eating out
31/5/2024,-6,ZARRAFFAS COFFEE GROVELY KEPERRA QLD AU Card xx4604,1447.89,Eating out
31/5/2024,-5,Marketcart Herston AU AUS Card xx4604 Value Date: 29/05/2024,1453.89,Food
31/5/2024,-14.13,YUMMO SUSHI SOUTH BRISBAN QL AUS Card xx4604 Value Date: 29/05/2024,1458.89,Food
30/5/2024,-1500,Transfer to xx3679 NetBank,1473.02,Eating out
30/5/2024,-19.95,UPDOC.COM.AU -KNPAGPWR,2973.02,Food
30/5/2024,-11.9,Guzman y Gomez ACD Albany Creek AU,2992.97,Food
30/5/2024,-12.9,Guzman y Gomez St Lucia QL AUS Card xx4604 Value Date: 29/05/2024,3004.87,Food
29/5/2024,726,Salary Q GROUP 28052024VAND,3017.77,Food
29/5/2024,-105.99,SUPER CHEAP AUTO EVE EVERTON PARK QL AUS Card xx4604 Value Date: 27/05/2024,2291.77,Travel
29/5/2024,-22.95,DBS*Fitness Cartel Asp Aspley QL AUS Card xx4604 Value Date: 27/05/2024,2397.76,Eating out
29/5/2024,-27.08,CellOPark Australia Matraville NS AUS Card xx4604 Value Date: 27/05/2024,2420.71,Eating out
28/5/2024,-21,ZAIHOU PTY LTD BRISBANE CITYAU Card xx4604,2447.79,Eating out
28/5/2024,-13.01,SQ *HEY MR.DUTTON PARK Dutton Park AU,2468.79,Travel
28/5/2024,-8.9,CHERMSIDE BUTCHER CHERMSIDE QL AUS Card xx4604 Value Date: 25/05/2024,2481.8,Food
28/5/2024,-5.55,SQ *BRISBEAN COFFEE Alderley AU,2490.7,Eating out
27/5/2024,-14.13,SQ *HEY MR.DUTTON PARK Dutton Park AU,2496.25,Travel
27/5/2024,-4.98,SQ *HEY MR.DUTTON PARK Dutton Park AU,2510.38,Travel
27/5/2024,-13.62,SQ *BRISBEAN COFFEE Alderley AU,2515.36,Travel
26/5/2024,-4.56,SQ *SAINT LUCY CAFFE St lucia AU,2528.98,Food
26/5/2024,-2.65,DAN DAN DRINKS PTY LTD Middle ParQLDAU,2533.54,Eating out
26/5/2024,-1.25,IGA ST LUCIA ST LUCIA AU Card xx4604,2536.19,Food
26/5/2024,-26.7,YINGHONG ZHANG ST LUCIA QLD AU Card xx4604,2537.44,Eating out
25/5/2024,-3.6,COLES 4547 CHERMSIDE AU,2564.14,Food
25/5/2024,-5,Cafe 641.5 Chermside Chermside AU,2567.74,Utilities
25/5/2024,-6.5,Cafe 641.5 Chermside Chermside AU,2572.74,Eating out
25/5/2024,-5.5,SQ *COFFEE BARRE Aspley AU,2579.24,Eating out
25/5/2024,-5.4,BOOKMARK CAFE ST LUCIA QL AUS Card xx4604 Value Date: 23/05/2024,2584.74,Food
24/5/2024,-2.5,Gecko Vending - Wararb Wamuran QLDAU,2590.14,Food
24/5/2024,-18.09,SQ *HEY MR.DUTTON PARK Dutton Park AU,2592.64,Food
23/5/2024,-19.95,UPDOC.COM.AU -KNPAGPWR,2610.73,Eating out
23/5/2024,-13.62,SQ *BRISBEAN COFFEE Alderley AU,2630.68,Travel
22/5/2024,726,Salary Q GROUP 21052024VAND,2644.3,Eating out
22/5/2024,-14.17,UQU Main Refectory St Lucia AU,1918.3,Utilities
22/5/2024,-9.2,LAKESIDE ENTERPRISES UNIVERSITY OFAU Card xx4604,1932.47,Travel
22/5/2024,-21,LAKESIDE ENTERPRISES UNIVERSITY OFAU Card xx4604,1941.67,Food
22/5/2024,-19,CASSIS AUSTRALIA PTY L WOOLLOONGABBA AU AUS Card xx4604 Value Date: 20/05/2024,1962.67,Food
22/5/2024,-22.95,DBS*Fitness Cartel Asp Aspley QL AUS Card xx4604 Value Date: 20/05/2024,1981.67,Food
22/5/2024,-5.4,7-ELEVEN 4098 ASPLEY QL AUS Card xx4604 Value Date: 19/05/2024,2004.62,Food
22/5/2024,-100.11,CALTEX EVERTON PARK EVERTON PARK AUS Card xx4604 Value Date: 18/05/2024,2010.02,Travel
22/5/2024,-5.99,THE STANDARD MARKET C SOUTHPORT AUS Card xx4604 Value Date: 19/05/2024,2110.13,Food
22/5/2024,-30,TRANSLINK BRISBANE AUS Card xx4604 Value Date: 21/05/2024,2116.12,Eating out
21/5/2024,-4.2,DRAKE SUPERMARKETS M MCDOWALL AU,2146.12,Eating out
21/5/2024,-1.1,MCDONALDS CENTRAL BRISBANE CITYQLDAU,2150.32,Food
21/5/2024,-1.1,MCDONALDS CENTRAL BRISBANE CITYQLDAU,2151.42,Travel
21/5/2024,-15.8,CHAPTER 3 BRISBANE CITY AU,2152.52,Eating out
21/5/2024,-2.5,Gecko Vending - Wararb Wamuran QLDAU,2168.32,Food
21/5/2024,-5.59,SQ *HEY MR.DUTTON PARK Dutton Park AU,2170.82,Entertainment
21/5/2024,-4.45,Microsoft*Store Sydney AU AUS Card xx4604 Value Date: 18/05/2024,2176.41,Food
21/5/2024,-62.99,SUPER CHEAP AUTO CHERMSIDE QL AUS Card xx4604 Value Date: 18/05/2024,2180.86,Utilities
21/5/2024,-21.69,SUPER CHEAP AUTO KEPERRA QL AUS Card xx4604 Value Date: 18/05/2024,2243.85,Eating out
21/5/2024,-25,MED*ALDIMobile CHATSWOOD AU AUS Card xx4604 Value Date: 19/05/2024,2265.54,Eating out
21/5/2024,-13.62,SQ *BRISBEAN COFFEE Alderley AU,2290.54,Food
20/5/2024,-169,99 Bikes Everton Park Everton Park AU,2304.16,Eating out
20/5/2024,-5.08,SQ *HEY MR.DUTTON PARK Dutton Park AU,2473.16,Eating out
20/5/2024,-2.5,Gecko Vending - Wararb Wamuran QLDAU,2478.24,Travel
20/5/2024,-2.54,SQ *HEY MR.DUTTON PARK Dutton Park AU,2480.74,Food
20/5/2024,-13.62,SQ *BRISBEAN COFFEE Alderley AU,2483.28,Utilities
18/5/2024,-68.9,BLURB HOLDINGS PTY L SURFERS PARA AU,2496.9,Eating out
18/5/2024,-0.45,BP LOGAN MOTOWAY695 LARAPINTA AU,2565.8,Eating out
18/5/2024,-6,ZARRAFFAS COFFEE GROVELY KEPERRA QLD AU Card xx4604,2566.25,Eating out
18/5/2024,-5.3,BAR MERLO UQ BRISBANE QL AUS Card xx4604 Value Date: 16/05/2024,2572.25,Eating out
18/5/2024,-8.6,SUSHI HUB ALBERT ST BRISBANE CITY QL AUS Card xx4604 Value Date: 15/05/2024,2577.55,Eating outuções
17/5/2024,-6.9,Krispy Kreme Albert St 131 Queen StrAU,2586.15,Eating out
17/5/2024,-23.5,ZAIHOU PTY LTD BRISBANE CITYAU Card xx4604,2593.05,Eating out
17/5/2024,-8.07,SQ *BRISBEAN COFFEE Alderley AU,2616.55,Eating out
17/5/2024,-6.56,SQ *BRISBEAN COFFEE Alderley AU,2624.62,Entertainment
17/5/2024,-4,CantaloupeSystemsAustr Albion QL AUS Card xx4604 Value Date: 15/05/2024,2631.18,Eating out
17/5/2024,-12.1,UQU Main Refectory St Lucia QL AUS Card xx4604 Value Date: 16/05/2024,2635.18,Eating out
17/5/2024,-5.35,THE UNIVERSITY OF QU ST LUCIA AUS Card xx4604 Value Date: 16/05/2024,2647.28,Food
16/5/2024,-9.6,UQU Main Refectory St Lucia AU,2652.63,Eating out
16/5/2024,-8.48,UQU Bakery St Lucia AU,2662.23,Food
16/5/2024,-7.93,SQ *HEY MR.DUTTON PARK Dutton Park QL AUS Card xx4604 Value Date: 14/05/2024,2670.71,Eating out
15/5/2024,726,Salary Q GROUP 14052024VAND,2678.64,Eating out
15/5/2024,-4.5,Krispy Kreme Albert St 131 Queen StrAU,1952.64,Eating out
15/5/2024,-7.54,UQU Main Refectory St Lucia AU,1957.14,Eating out
15/5/2024,-5.55,SQ *BRISBEAN COFFEE Alderley AU,1964.68,Eating out
15/5/2024,-5.3,BAR MERLO UQ BRISBANE QL AUS Card xx4604 Value Date: 11/05/2024,1970.23,Eating out
15/5/2024,-22.95,DBS*Fitness Cartel Asp Aspley QL AUS Card xx4604 Value Date: 13/05/2024,1975.53,Food
15/5/2024,-8.8,SUSHI HUB ALBERT ST BRISBANE CITY QL AUS Card xx4604 Value Date: 12/05/2024,1998.48,Eating out
15/5/2024,1738.08,Return UNITED1623873508600 CONTINENTAL AU AUS Card xx4604 Value Date: 11/05/2024,2007.28,Eating out
14/5/2024,-13,CHEZ NOUS CAFE BRISBANE QL AUS Card xx4604 Value Date: 10/05/2024,269.2,Travel
14/5/2024,-8.17,YO CHI ALBERT ST BRISBANE ADEL QL AUS Card xx4604 Value Date: 10/05/2024,282.2,Utilities
14/5/2024,-1.25,WOOLWORTHS 2583 STAFFORD AU AUS Card xx4604 Value Date: 11/05/2024,290.37,Food
14/5/2024,-6.1,THE BAGEL BOYS PTY LTD ST LUCIA AU AUS Card xx4604 Value Date: 11/05/2024,291.62,Food
14/5/2024,-4,CantaloupeSystemsAustr Albion QL AUS Card xx4604 Value Date: 11/05/2024,297.72,Eating out
14/5/2024,-1738.08,UNITED1623873508600 CONTINENTAL AU AUS Card xx4604 Value Date: 10/05/2024,301.72,Eating out
13/5/2024,-11.1,DRAKE SUPERMARKETS M MCDOWALL AU,2039.8,Food
13/5/2024,-8.13,SQ *HEY MR.DUTTON PARK Dutton Park AU,2050.9,Utilities
12/5/2024,-79,Lululemon Brisbane AU,2059.03,Eating out
12/5/2024,-52.9,Nutrition Warehouse Brisbane AU,2138.03,Eating out
12/5/2024,-7.5,STARBUCKS COFFEE D00 BRISBANE AU,2190.93,Utilities
12/5/2024,-11.05,STARBUCKS COFFEE D02 BRISBANE AU,2198.43,Food
11/5/2024,-24,KMART 1275 STAFFORD AU,2209.48,Eating out
10/5/2024,-17.98,Thai Street Kitchen Brisbane AU,2233.48,Eating out
10/5/2024,-29.9,FEATHER.COM.AU KINCUMBER NS AUS Card xx4604 Value Date: 08/05/2024,2251.46,Food
10/5/2024,-16.67,THE BAGEL BOYS PTY LTD ST LUCIA AU AUS Card xx4604 Value Date: 08/05/2024,2281.36,Entertainment
10/5/2024,-4,CantaloupeSystemsAustr Albion QL AUS Card xx4604 Value Date: 08/05/2024,2298.03,Eating out
10/5/2024,-14.3,SUSHI HUB ALBERT ST BRISBANE CITY QL AUS Card xx4604 Value Date: 07/05/2024,2302.03,Eating out
10/5/2024,-30,TRANSLINK BRISBANE AUS Card xx4604 Value Date: 08/05/2024,2316.33,Eating out
9/5/2024,30,Fast Transfer From LOURDES VAN DER NEUT Food,2346.33,Eating out
9/5/2024,-6,ZARRAFFAS COFFEE GROVELY KEPERRA QLD AU Card xx4604,2316.33,Eating out
9/5/2024,-29.4,KFC ASPLEY ASPLEY QL AUS Card xx4604 Value Date: 06/05/2024,2322.33,Eating out
9/5/2024,-11.98,MR TOYS TOYWORLD ASPLEY QL AUS Card xx4604 Value Date: 06/05/2024,2351.73,Eating out
8/5/2024,-1.1,MCDONALDS QUEEN ST BRISBANE QLDAU,2363.71,Eating out
8/5/2024,-24.1,ZAIHOU PTY LTD BRISBANE CITYAU Card xx4604,2364.81,Eating out
8/5/2024,521.38,Salary Q GROUP 07052024VAND,2388.91,Food
8/5/2024,-17,UQ SPORT LTD ST LUCIA AU,1867.53,Eating out
8/5/2024,-6.08,UQ STORE PTY LTD St Lucia AU,1884.53,Eating out
8/5/2024,-22.95,DBS*Fitness Cartel Asp Aspley QL AUS Card xx4604 Value Date: 06/05/2024,1890.61,Eating out
8/5/2024,-61,Bulk Nutrients 61362664725 TA AUS Card xx4604 Value Date: 05/05/2024,1913.56,Food
7/5/2024,-17.18,SQ *HEY MR.DUTTON PARK Dutton Park AU,1974.56,Food
7/5/2024,-46.77,WWW.ALHGROUP.COM* ME&U SYDNEY NS AUS Card xx4604 Value Date: 03/05/2024,1991.74,Eating out
7/5/2024,-33.5,SMP*Cafe 63 Chermside Chermside AU AUS Card xx4604 Value Date: 05/05/2024,2038.51,Eating out
7/5/2024,-17.04,HAROL'S ESPRESSO PTY Brisbane CityAU,2072.01,Utilities
5/5/2024,-6,ZARRAFFAS COFFEE GROVELY KEPERRA QLD AU Card xx4604,2089.05,Eating out
4/5/2024,-16.67,THE BAGEL BOYS PTY LTD ST LUCIA AU AUS Card xx4604 Value Date: 02/05/2024,2095.05,Entertainment
4/5/2024,-4.7,BAR MERLO UQ BRISBANE QL AUS Card xx4604 Value Date: 02/05/2024,2111.72,Eating out
4/5/2024,-5.64,TCC Everton Hills Everton Hills QL AUS Card xx4604 Value Date: 01/05/2024,2116.42,Eating out
4/5/2024,-50.17,COLES EXPRESS 1775 ASPLEY AU AUS Card xx4604 Value Date: 02/05/2024,2122.06,Eating out
3/5/2024,-17.9,VIETS ROLL STREET FOOD WOOLLOONGABBAAU,2172.23,Eating out
3/5/2024,-14.03,SQ *HEY MR.DUTTON PARK Dutton Park AU,2190.13,Eating out
3/5/2024,-3.75,DRAKE SUPERMARKETS M MCDOWALL AUS Card xx4604 Value Date: 30/04/2024,2204.16,Eating out
2/5/2024,278,Salary Q GROUP 30042024VAND,2207.91,Eating out
2/5/2024,-11.1,Boost Albert Street Brisbane AU,1929.91,Eating out
2/5/2024,-13.4,CHEZ NOUS CAFE BRISBANE QL AUS Card xx4604 Value Date: 30/04/2024,1941.01,Entertainment
2/5/2024,-10,SUSHI TRAIN ASPLEY ASPLEY QL AUS Card xx4604 Value Date: 29/04/2024,1954.41,Food
1/5/2024,507,Salary Q GROUP 30042024VAND,1964.41,Travel
1/5/2024,-5.4,7-ELEVEN 4166 ASPLEY QL AUS Card xx4604 Value Date: 29/04/2024,1457.41,Food
1/5/2024,-22.95,DBS*Fitness Cartel Asp Aspley QL AUS Card xx4604 Value Date: 29/04/2024,1462.81,Eating out
1/5/2024,-5,FITNESS CARTEL ASPLE ASPLEY QL AUS Card xx4604 Value Date: 27/04/2024,1485.76,Travel
1/5/2024,-4.79,SMITHAM BREWERY PTY MURARRIE AUS Card xx4604 Value Date: 27/04/2024,1490.76,Food
1/5/2024,-48.64,SMITHAM BREWERY PTY MURARRIE AUS Card xx4604 Value Date: 27/04/2024,1495.55,Utilities
1/5/2024,-6.2,FOSTER & BLACK P/L CHERMSIDE QL AUS Card xx4604 Value Date: 28/04/2024,1544.19,Food
30/4/2024,-5.79,SQ *BREADTOP MYER CENT Brisbane City AU,1550.39,Food
30/4/2024,-16.25,MEKONG 2 CITY PTY LTD Brisbane AU,1556.18,Eating out
30/4/2024,-27,Thalassina West End QL AUS Card xx4604 Value Date: 26/04/2024,1572.43,Food
30/4/2024,-3.5,CantaloupeSystemsAustr Albion QL AUS Card xx4604 Value Date: 26/04/2024,1599.43,Eating out
30/4/2024,-5.3,BAR MERLO UQ BRISBANE QL AUS Card xx4604 Value Date: 26/04/2024,1602.93,Eating out
30/4/2024,-15.6,CantaloupeSystemsAustr Albion QL AUS Card xx4604 Value Date: 25/04/2024,1608.23,Eating out
30/4/2024,-5.7,CantaloupeSystemsAustr Albion QL AUS Card xx4604 Value Date: 25/04/2024,1623.83,Eating out
30/4/2024,-34.35,MCDONALDS DT 1040 MILTON AUS Card xx4604 Value Date: 25/04/2024,1629.53,Eating out
30/4/2024,-21.9,YINGHONG ZHANG ST LUCIA AUS Card xx4604 Value Date: 25/04/2024,1663.88,Eating out
30/4/2024,-10.5,LAKESIDE ENTERPRISEQPS UNIVERSITY OF AUS Card xx4604 Value Date: 26/04/2024,1685.78,Eating out
30/4/2024,-4.5,HG RETAIL PTY LTD ST LUCIA AUS Card xx4604 Value Date: 25/04/2024,1696.28,Eating out
30/4/2024,-25,KMART 1218 ASPLEY AU AUS Card xx4604 Value Date: 27/04/2024,1700.78,Eating out
30/4/2024,-9.9,7-ELEVEN 4100 FORTITUDE VAL QL AUS Card xx4604 Value Date: 27/04/2024,1725.78,Utilities
30/4/2024,-27.65,SQ *HEY MR.DUTTON PARK Dutton Park QL AUS Card xx4604 Value Date: 29/04/2024,1735.68,Eating out
30/4/2024,-8,WESTFIELD CHERMSIDE CHERMSIDE AUS Card xx4604 Value Date: 28/04/2024,1763.33,Eating out
29/4/2024,-19.31,SQ *HEY MR.DUTTON PARK Dutton Park AU,1771.33,Eating out
28/4/2024,-8.25,EVENT CINEMAS CHERMS CHERMSIDE AU Card xx4604,1790.64,Eating out
28/4/2024,-28,EVENT CINEMAS CHERMS CHERMSIDE AU Card xx4604,1798.89,Eating out
28/4/2024,-22.2,ZAIHOU PTY LTD CHERMSIDE AU Card xx4604,1826.89,Eating out
27/4/2024,-27.5,chicken of rock Fortitude ValAU,1849.09,Food
27/4/2024,-2.85,DAN DAN DRINKS PTY LTD Middle Park AU AUS Card xx4604 Value Date: 25/04/2024,1876.59,Food
27/4/2024,-53.07,COLES EXPRESS 2149 KEDRON AU AUS Card xx4604 Value Date: 25/04/2024,1879.44,Eating out
26/4/2024,-1.1,MCDONALDS DT 0974 NEWMARKET QLDAU,1932.51,Eating out
26/4/2024,-10.8,LAKESIDE ENTERPRISES UNIVERSITY OFAU Card xx4604,1933.61,Eating out
25/4/2024,-30,TRANSLINK BRISBANE AUS Card xx4604 Value Date: 23/04/2024,1944.41,Food
24/4/2024,752.75,Salary Q GROUP 23042024VAND,1974.41,Eating out
24/4/2024,-4.5,Krispy Kreme Albert St 131 Queen StrAU,1221.66,Eating out
24/4/2024,-15.96,Thai Street Kitchen Brisbane AU,1226.16,Eating out
24/4/2024,-18,VIETS ROLL STREET FOOD WOOLLOONGABBAAU,1242.12,Food
24/4/2024,-9.96,SQ *HEY MR.DUTTON PARK Dutton Park AU,1260.12,Eating out
24/4/2024,-18.95,DBS*Fitness Cartel Asp Aspley QL AUS Card xx4604 Value Date: 22/04/2024,1270.08,Food
24/4/2024,-5.4,7-ELEVEN 4166 ASPLEY QL AUS Card xx4604 Value Date: 21/04/2024,1289.03,Eating out
24/4/2024,-6.2,FOSTER & BLACK P/L CHERMSIDE QL AUS Card xx4604 Value Date: 20/04/2024,1294.43,Eating out
23/4/2024,-19.31,SQ *HEY MR.DUTTON PARK Dutton Park AU,1300.63,Eating out
23/4/2024,-5.08,SQ *HEY MR.DUTTON PARK Dutton Park AU,1319.94,Entertainment
23/4/2024,-6.3,TRANSLINK BRISBANE AUS Card xx4604 Value Date: 18/04/2024,1325.02,Eating out
23/4/2024,-6.3,CARSELDINE STATION CARSELDINE AUS Card xx4604 Value Date: 18/04/2024,1331.32,Eating out
23/4/2024,-6.7,MEKONG CHERMSIDE Chermside QL AUS Card xx4604 Value Date: 20/04/2024,1337.62,Eating out
23/4/2024,-6.97,H2 AUSTRALIA PTY LTD CHERMSIDE QL AUS Card xx4604 Value Date: 21/04/2024,1344.32,Food
23/4/2024,-8.13,SQ *HEY MR.DUTTON PARK Dutton Park AU,1351.29,Food
22/4/2024,-17.18,SQ *HEY MR.DUTTON PARK Dutton Park AU,1359.42,Eating out
22/4/2024,-10.09,SQ *BRISBEAN COFFEE Alderley AU,1376.6,Eating out
20/4/2024,-10.81,YO CHI ALBERT ST BRISBANE ADEL QL AUS Card xx4604 Value Date: 18/04/2024,1386.69,Eating out
20/4/2024,-14.17,UQU Main Refectory St Lucia QL AUS Card xx4604 Value Date: 18/04/2024,1397.5,Food
20/4/2024,-12.5,Marketcart Herston AU AUS Card xx4604 Value Date: 18/04/2024,1411.67,Eating out
20/4/2024,-25,MED*ALDIMobile CHATSWOOD AU AUS Card xx4604 Value Date: 18/04/2024,1424.17,Eating out
19/4/2024,-18.99,Boondall Cellars Boondall AU,1449.17,Eating out
19/4/2024,-16.9,VIETS ROLL STREET FOOD WOOLLOONGABBAAU,1468.16,Food
19/4/2024,-9.96,SQ *HEY MR.DUTTON PARK Dutton Park AU,1485.06,Eating out
19/4/2024,-12.11,SQ *BRISBEAN COFFEE Alderley AU,1495.02,Eating out
19/4/2024,-15,COLES 4670 ASPLEY AU AUS Card xx4604 Value Date: 17/04/2024,1507.13,Food
19/4/2024,-31,KMART 1218 ASPLEY AU AUS Card xx4604 Value Date: 17/04/2024,1522.13,Eating out
19/4/2024,-3,FITNESS CARTEL ASPLE ASPLEY QL AUS Card xx4604 Value Date: 17/04/2024,1553.13,Eating out
19/4/2024,-9.5,SMP*Cafe 63 Chermside Chermside AU AUS Card xx4604 Value Date: 17/04/2024,1556.13,Food
19/4/2024,-309,BCC INFRINGEMENTS BRISBANE AUS Card xx4604 Value Date: 18/04/2024,1565.63,Eating out
18/4/2024,-27,Urban Climb West End West End AU AUS Card xx4604 Value Date: 16/04/2024,1874.63,Eating out
18/4/2024,-30,TARGET 5184 BRISBANE AU AUS Card xx4604 Value Date: 16/04/2024,1901.63,Eating out
17/4/2024,699.25,Salary Q GROUP 16042024VAND,1931.63,Eating out
17/4/2024,-8,BPCN CABO STH 1677 CABOOLTURE QL AUS Card xx4604 Value Date: 14/04/2024,1232.38,Eating out
17/4/2024,-104.48,BP CON CABLTR NTH 1672 CABOOLTURE QL AUS Card xx4604 Value Date: 12/04/2024,1240.38,Eating out
17/4/2024,-18.95,DBS*Fitness Cartel Asp Aspley QL AUS Card xx4604 Value Date: 15/04/2024,1344.86,Eating out
17/4/2024,-119.98,CARSELDINE CELLARS CARSELDINE AUS Card xx4604 Value Date: 12/04/2024,1363.81,Eating out
16/4/2024,-4.5,Krispy Kreme Albert St 131 Queen StrAU,1483.79,Entertainment
16/4/2024,-19.18,MONG THO TRAN PTY LT BRISBANE CITYQLDAU,1488.29,Eating out
16/4/2024,-9.66,SQ *HEY MR.DUTTON PARK Dutton Park AU,1507.47,Eating out
16/4/2024,-35,SQ *JUNGLE LOVE FESTIV Enoggera QL AUS Card xx4604 Value Date: 12/04/2024,1517.13,Eating out շաբաթ
16/4/2024,-18.65,KFC CABOOLTURE NTH CABOOLTURE QL AUS Card xx4604 Value Date: 12/04/2024,1552.13,Eating out
15/4/2024,50,Fast Transfer From MR MELVIN JAMES DAYAG Essential supplies Essential supplies,1570.78,Eating out
15/4/2024,-9.66,SQ *HEY MR.DUTTON PARK Dutton Park AU,1520.78,Eating out
15/4/2024,-10.09,SQ *BRISBEAN COFFEE Alderley AU,1530.44,Food
14/4/2024,-12.95,MCDONALDS BP CABOOLTU BURPENGARY QLDAU,1540.53,Eating out
13/4/2024,-5.4,BOOKMARK CAFE ST LUCIA QL AUS Card xx4604 Value Date: 11/04/2024,1553.48,Eating out
13/4/2024,-9.6,UQU Main Refectory St Lucia QL AUS Card xx4604 Value Date: 11/04/2024,1558.88,Eating out
13/4/2024,-28.85,LS YKC Investment Trus Brisbane City AU AUS Card xx4604 Value Date: 11/04/2024,1568.48,Eating out
13/4/2024,-12.81,YO CHI ALBERT ST BRISBANE ADEL QL AUS Card xx4604 Value Date: 11/04/2024,1597.33,Eating out
12/4/2024,-6.2,BP CON CABLTR NTH 1 CABOOLTURE AU,1610.14,Eating out
12/4/2024,-5.08,SQ *HEY MR.DUTTON PARK Dutton Park AU,1616.34,Food
11/4/2024,-19.18,MONG THO TRAN PTY LT BRISBANE CITYQLDAU,1621.42,Eating out
11/4/2024,-5.7,STARBUCKS COFFEE D00 BRISBANE AU,1640.6,Eating out
11/4/2024,-26,CASSIS AUSTRALIA PTY L WOOLLOONGABBA AU AUS Card xx4604 Value Date: 09/04/2024,1646.3,Eating out
10/4/2024,900,Salary Q GROUP 09042024VAND,1672.3,Eating out
10/4/2024,388.75,Salary HSW Group Servic 46097/04/2024,772.3,Eating out
10/4/2024,-13.25,MCDONALDS ASPLEY ASPLEY QLDAU,383.55,Eating out
10/4/2024,-6.64,TCC Everton Hills Everton Hills QL AUS Card xx4604 Value Date: 07/04/2024,396.8,Eating out
10/4/2024,-18.95,DBS*Fitness Cartel Asp Aspley QL AUS Card xx4604 Value Date: 08/04/2024,403.44,Eating out
10/4/2024,-11.4,JCT QUEENSLAND P/L BRISBANE AUS Card xx4604 Value Date: 05/04/2024,422.39,Eating out
9/4/2024,-15.96,Thai Street Kitchen Brisbane QL AUS Card xx4604 Value Date: 05/04/2024,433.79,Eating outԵղարկա
9/4/2024,-7,7-ELEVEN 4084 BRISBANE QL AUS Card xx4604 Value Date: 04/04/2024,449.75,Eating out
9/4/2024,-10.3,SUSHI HUB ALBERT ST BRISBANE CITY QL AUS Card xx4604 Value Date: 04/04/2024,456.75,Eating out
9/4/2024,-6.64,TCC Everton Hills Everton Hills QL AUS Card xx4604 Value Date: 06/04/2024,467.05,Eating out
9/4/2024,-30,TRANSLINK BRISBANE AUS Card xx4604 Value Date: 08/04/2024,473.69,Eating out
9/4/2024,-10.09,SQ *BRISBEAN COFFEE Alderley AU,503.69,Eating out
8/4/2024,-18,VIETS ROLL STREET FOOD WOOLLOONGABBAAU,513.78,Eating out
8/4/2024,-2.54,SQ *HEY MR.DUTTON PARK Dutton Park AU,531.78,Eating out
8/4/2024,-11.15,SQ *HEY MR.DUTTON PARK Dutton Park AU,534.32,Eating out
6/4/2024,-4.5,MRS BROWN'S BAR & KIT Newstead AU,545.47,Eating out
6/4/2024,-29,MRS BROWN'S BAR & KIT Newstead AU,549.97,Eating out
6/4/2024,-7.98,GZ BLUE PTY LTD BRISBANE CITY AUS Card xx4604 Value Date: 03/04/2024,578.97,Eating out
5/4/2024,-2.5,TARGET 5184 BRISBANE AU,586.95,Eating out
5/4/2024,5.59,Refund Purchase SQ *HEY MR.DUTTON PARK Dutton Park AU,589.45,Eating out
5/4/2024,-10.16,SQ *HEY MR.DUTTON PARK Dutton Park AU,583.86,Eating out
5/4/2024,-5.59,SQ *HEY MR.DUTTON PARK Dutton Park AU,594.02,Eating out
5/4/2024,-30,TARGET 5184 BRISBANE AU AUS Card xx4604 Value Date: 03/04/2024,599.61,Food
5/4/2024,-17,VIETS ROLL STREET FOOD WOOLLOONGABBA AUS Card xx4604 Value Date: 03/04/2024,629.61,Entertainment
4/4/2024,-13,LAKESIDE ENTERPRISES UNIVERSITY OFAU Card xx4604,646.61,Food
4/4/2024,-18.95,DBS*Fitness Cartel Asp Aspley QL AUS Card xx4604 Value Date: 02/04/2024,659.61,Eating out
4/4/2024,-34.93,LS YKC Investment Trus Brisbane City AU AUS Card xx4604 Value Date: 02/04/2024,678.56,Eating out
3/4/2024,278,Salary Q GROUP 02042024VAND,713.49,Eating out
3/4/2024,-12.2,SQ *RICE AND MEE Brisbane City AU,435.49,Eating out
3/4/2024,-71.49,Dominos Estore Carseld dominos.com.a AU AUS Card xx4604 Value Date: 28/03/2024,447.69,Eating out
3/4/2024,-56.43,CHEMIST WAREHOUSE CHERMSIDE QL AUS Card xx4604 Value Date: 27/03/2024,519.18,Eating out
3/4/2024,-10.17,YO CHI ALBERT ST BRISBANE ADEL QL AUS Card xx4604 Value Date: 28/03/2024,575.61,Eating out
3/4/2024,-3.5,COLES EXPRESS 1775 ASPLEY AU AUS Card xx4604 Value Date: 27/03/2024,585.78,Eating out
3/4/2024,-12.55,8TH MCDOWALL CAFE PTY MCDOWALL AU AUS Card xx4604 Value Date: 29/03/2024,589.28,Eating out
3/4/2024,-5.9,BAR MERLO UQ BRISBANE QL AUS Card xx4604 Value Date: 28/03/2024,601.83,Eating out
3/4/2024,-16.83,HOWARDSMITHWHARV* ME&U BRISBANE CITY QL AUS Card xx4604 Value Date: 30/03/2024,607.73,Eating out
3/4/2024,-3,7 ELEVEN 4229 EVERTON HILLS QL AUS Card xx4604 Value Date: 30/03/2024,624.56,Eating out
3/4/2024,-10.32,TCC Everton Hills Everton Hills QL AUS Card xx4604 Value Date: 30/03/2024,627.56,Eating out
3/4/2024,-33.93,SMP*Cafe 63 Chermside Chermside AU AUS Card xx4604 Value Date: 31/03/2024,637.88,Eating out
3/4/2024,-26.21,DD *DOORDASH HAKATAYAR MELBOURNE VI AUS Card xx4604 Value Date: 31/03/2024,671.81,Eating out
3/4/2024,-67.96,FITNESS CARTEL ASPLE ASPLEY QL AUS Card xx4604 Value Date: 29/03/2024,698.02,Eating out
3/4/2024,-8.36,YO GET IT QLD CHERMSIDE QL AUS Card xx4604 Value Date: 31/03/2024,765.98,eating out Fighting
3/4/2024,25,Return Tickets*EWB UQ x Q BELROSE AU AUS Card xx4604 Value Date: 28/03/2024,774.34,eating out
3/4/2024,-15.04,SQ *HEY MR.DUTTON PARK Dutton Park AU,749.34,eating out
1/4/2024,-20.58,Guzman y Gomez ACD Albany Creek AU,764.38,Eating out
30/3/2024,-1,The Trustee for AEK HS Brisbane CQLDAU,784.96,Eating out
30/3/2024,-3.2,The Trustee for AEK HS Brisbane CQLDAU,785.96,Eating out
29/3/2024,-15.9,MEKONG 2 CHINESE AND V CHERMSIDE AU AUS Card xx4604 Value Date: 27/03/2024,789.16,Eating out
28/3/2024,-8,LAKESIDE ENTERPRISES UNIVERSITY OFAU Card xx4604,805.06,Food
28/3/2024,-0.36,7-ELEVEN 4166 ASPLEY QL AUS Card xx4604 Value Date: 25/03/2024,813.06,Eating out
28/3/2024,-11.68,CellOPark Australia Matraville NS AUS Card xx4604 Value Date: 26/03/2024,813.42,Eating out
27/3/2024,671.5,Salary Q GROUP 26032024VAND,825.1,Eating out
27/3/2024,-5,MCDONALDS ASPLEY ASPLEY QLDAU,153.6,Food
27/3/2024,-295,KARL HEINZ RODINS CHERMSIDE QLD AU Card xx4604,158.6,Eating out
27/3/2024,400,Transfer from xx3679 CommBank app,453.6,Eating out
27/3/2024,-27,CASSIS AUSTRALIA PTY L WOOLLOONGABBA AU AUS Card xx4604 Value Date: 25/03/2024,53.6,Eating out
27/3/2024,-5,QUT PARKING KELVIN GROVE QL AUS Card xx4604 Value Date: 24/03/2024,80.6,Eating out
27/3/2024,-18.95,DBS*Fitness Cartel Asp Aspley QL AUS Card xx4604 Value Date: 25/03/2024,85.6,Eating out
27/3/2024,-19.18,MONG THO TRAN PTY LT BRISBANE CITY QL AUS Card xx4604 Value Date: 22/03/2024,104.55,Eating out
26/3/2024,-26,VIETS ROLL STREET FOOD WOOLLOONGABBAAU,123.73,Eating out
26/3/2024,-10.73,YO CHI ALBERT ST BRISBANE ADEL QL AUS Card xx4604 Value Date: 22/03/2024,149.73,Eating out
26/3/2024,-6.64,TCC Everton Hills Everton Hills QL AUS Card xx4604 Value Date: 21/03/2024,160.46,Eating out
26/3/2024,-5.4,7-ELEVEN 4098 ASPLEY QL AUS Card xx4604 Value Date: 22/03/2024,167.1,Eating out
26/3/2024,-17.5,7 ELEVEN VIRGINIA 42 VIRGINIA QL AUS Card xx4604 Value Date: 23/03/2024,172.5,Eating out
26/3/2024,-6.64,TCC Everton Hills Everton Hills QL AUS Card xx4604 Value Date: 23/03/2024,190,Eating out
26/3/2024,-5,SMP*Cafe 63 Chermside Chermside AU AUS Card xx4604 Value Date: 24/03/2024,196.64,Eating out
26/3/2024,-30,TRANSLINK BRISBANE AUS Card xx4604 Value Date: 25/03/2024,201.64,Eating out
23/3/2024,-3.5,COLES EXPRESS 1775 ASPLEY AU AUS Card xx4604 Value Date: 20/03/2024,231.64,Eating out
22/3/2024,-16.77,SQ *HEY MR.DUTTON PARK Dutton Park AU,235.14,Eating out
22/3/2024,-5.1,8TH MCDOWALL CAFE PTY MCDOWALL AU AUS Card xx4604 Value Date: 20/03/2024,251.91,Eating out
21/3/2024,80,Transfer from xx3679 CommBank app,257.01,Eating out
