Date,Credit/Debit,Transaction Name,Balance
04/07/2024,-100,Transfer to xx1056 CommBank app,120.29
04/07/2024,-19.39,UBER* TRIP SYDNEY NS AUS Card xx5077 Value Date: 02/07/2024,220.29
04/07/2024,-35.37,DiDiMobility Sydney AU AUS Card xx5077 Value Date: 02/07/2024,239.68
04/07/2024,-10,MY STREET FOOD PTY L WOOLLOONGABBA QL AUS Card xx5077 Value Date: 02/07/2024,275.05
04/07/2024,-14.5,MY STREET FOOD PTY L WOOLLOONGABBA QL AUS Card xx5077 Value Date: 02/07/2024,285.05
03/07/2024,-13.3,DIGITALOCEAN.COM GROSVENOR PLA NS AUS Card xx5077 Value Date: 01/07/2024,299.55
03/07/2024,-12.68,UBER *TRIP Sydney AU AUS Card xx5077 Value Date: 01/07/2024,312.85
03/07/2024,-40,MY STREET FOOD PTY L WOOLLOONGABBA QL AUS Card xx5077 Value Date: 01/07/2024,325.53
03/07/2024,174.46,Salary ALH GROUP 236263,365.53
02/07/2024,100,Transfer from xx1056 CommBank app,191.07
02/07/2024,-83,SQ *CIROS ITALIAN Woolloongabba QL AUS Card xx5077 Value Date: 28/06/2024,91.07
02/07/2024,-54.99,TPG INTERNET PTY LTD MACQUARIE PAR NS AUS Card xx5077 Value Date: 28/06/2024,174.07
02/07/2024,-39.92,UBER *EATS Sydney AU AUS Card xx5077 Value Date: 29/06/2024,229.06
02/07/2024,-20.19,UBER *EATS Sydney AU AUS Card xx5077 Value Date: 29/06/2024,268.98
02/07/2024,-59.37,UBER *EATS Sydney AU AUS Card xx5077 Value Date: 29/06/2024,289.17
02/07/2024,-9.73,UBER *TRIP Sydney AU AUS Card xx5077 Value Date: 29/06/2024,348.54
02/07/2024,-6.68,UBER *TRIP Sydney AU AUS Card xx5077 Value Date: 29/06/2024,358.27
02/07/2024,-12.92,UBER* TRIP SYDNEY NS AUS Card xx5077 Value Date: 30/06/2024,364.95
02/07/2024,-208.94,CONNECTED AUSTRALIA PT MOUNT GRAVATT AUS Card xx5077 Value Date: 01/07/2024,377.87
01/07/2024,300,Transfer from xx1056 CommBank app,586.81
29/06/2024,128,Transfer from xx0713 CommBank app,286.81
29/06/2024,-23.08,UBER *TRIP Sydney AU AUS Card xx5077 Value Date: 27/06/2024,158.81
29/06/2024,-12.14,UBER *TRIP Sydney AU AUS Card xx5077 Value Date: 27/06/2024,181.89
29/06/2024,-35.83,WOOLWORTHS 2865 WOOLLOONGABBA AU AUS Card xx5077 Value Date: 27/06/2024,194.03
29/06/2024,-23.83,UBER *TRIP Sydney AU AUS Card xx5077 Value Date: 27/06/2024,229.86
29/06/2024,-114,Transfer to xx0713 NetBank My purchase goal,253.69
29/06/2024,-200,Transfer to xx1056 NetBank My emergency fund,367.69
27/06/2024,-40,SQ *LE CHAPEL Woolloongabba QL AUS Card xx5077 Value Date: 25/06/2024,567.69
27/06/2024,-37.49,DidiChuxing DIDI MOBIL Sydney AU AUS Card xx5077 Value Date: 25/06/2024,607.69
27/06/2024,-12.43,DidiChuxing DIDI MOBIL Sydney AU AUS Card xx5077 Value Date: 25/06/2024,645.18
26/06/2024,-1500,Transfer to xx1056 CommBank app,657.61
26/06/2024,334.6,Salary UNI OF QLD 2263922 10712884,2157.61
26/06/2024,1092.16,Salary UNI OF QLD 2263920 10712884,1823.01
26/06/2024,-20.92,MIRCHH MASALA IMPEX WOOLLOONGABBA AUS Card xx5077 Value Date: 21/06/2024,730.85
26/06/2024,624.38,Salary ALH GROUP 236263,751.77
25/06/2024,-17,Transfer To J VAN-DER-NEUT PayID Phone from CommBank App Food,127.39
25/06/2024,-23.99,SQ *YUMS] CHICKEN - WO Woolloongabba QL AUS Card xx5077 Value Date: 21/06/2024,144.39
25/06/2024,-55,SQ *CIROS ITALIAN Woolloongabba QL AUS Card xx5077 Value Date: 21/06/2024,168.38
25/06/2024,-76.02,SQ *UNCLE DON SOUTH CI Woolloongabba QL AUS Card xx5077 Value Date: 22/06/2024,223.38
25/06/2024,-29.54,WOOLWORTHS 2865 WOOLLOONGABBA AU AUS Card xx5077 Value Date: 23/06/2024,299.4
25/06/2024,-16.75,Tickets*Queensland BELROSE AU AUS Card xx5077 Value Date: 22/06/2024,328.94
25/06/2024,100,Fast Transfer From DEEKSHA ANAND Cab,345.69
22/06/2024,100,Transfer from xx1056 CommBank app,245.69
22/06/2024,-5.4,WOOLWORTHS 2865 WOOLLOONGABBA AU AUS Card xx5077 Value Date: 20/06/2024,145.69
22/06/2024,-11.63,UBER *TRIP Sydney AU AUS Card xx5077 Value Date: 20/06/2024,151.09
22/06/2024,-9.55,UBER *TRIP Sydney AU AUS Card xx5077 Value Date: 20/06/2024,162.72
21/06/2024,80,Cardless Cash return Shop,172.27
21/06/2024,-3.08,Non CBA ATM Withdrawal Fee,92.27
21/06/2024,-80,Wdl ATM Red atmx 118 LOGAN RD WOOLLOONGA AU,95.35
21/06/2024,100,Transfer from xx1056 CommBank app,175.35
21/06/2024,-80,Cardless Cash for collection Shop,75.35
21/06/2024,-28.79,WOOLWORTHS 2865 WOOLLOONGABBA AU AUS Card xx5077 Value Date: 19/06/2024,155.35
21/06/2024,-14.26,DidiChuxing DIDI MOBIL Sydney AU AUS Card xx5077 Value Date: 19/06/2024,184.14
21/06/2024,-15.6,IGA PULLENVALE PULLENVALE QL AUS Card xx5077 Value Date: 18/06/2024,198.4
21/06/2024,-12.88,UBER *TRIP Sydney AU AUS Card xx5077 Value Date: 19/06/2024,214
21/06/2024,-9.13,UBER *TRIP Sydney AU AUS Card xx5077 Value Date: 19/06/2024,226.88
21/06/2024,-24,HARRIS FARM MARKETS PT WEST END AUS Card xx5077 Value Date: 19/06/2024,236.01
21/06/2024,-22,HARRIS FARM MARKETS PT WEST END AUS Card xx5077 Value Date: 19/06/2024,260.01
20/06/2024,-35.21,WOOLWORTHS 2865 WOOLLOONGABBA AU AUS Card xx5077 Value Date: 18/06/2024,282.01
19/06/2024,-14.61,DidiChuxing DIDI MOBIL Sydney AU AUS Card xx5077 Value Date: 17/06/2024,317.22
19/06/2024,-16.8,ALH VENUES 8010 WEST END AU AUS Card xx5077 Value Date: 17/06/2024,331.83
19/06/2024,-9.25,UBER* TRIP SYDNEY NS AUS Card xx5077 Value Date: 17/06/2024,348.63
19/06/2024,-12.67,UBER *TRIP Sydney AU AUS Card xx5077 Value Date: 17/06/2024,357.88
19/06/2024,-0.5,LITTLE RED DUMPLING WOOLLOONGABBA QL AUS Card xx5077 Value Date: 16/06/2024,370.55
19/06/2024,5,Return ANGELIKA FILM CENTRE WOOLLOONGABBA QL AUS Card xx5077 Value Date: 16/06/2024,371.05
19/06/2024,-200,Transfer to xx1056 NetBank My emergency fund,366.05
19/06/2024,378.91,Salary ALH GROUP 236263,566.05
18/06/2024,100,Transfer from xx0713 CommBank app,187.14
18/06/2024,-15.12,ORIENTAL CORNER St Lucia AU AUS Card xx5077 Value Date: 14/06/2024,87.14
18/06/2024,-50,SQ *SILKWOOD CANDLE CO Mount Cotton QL AUS Card xx5077 Value Date: 14/06/2024,102.26
18/06/2024,-4.27,KENKO SUSHI HOUSE ST LUCIA AU AUS Card xx5077 Value Date: 14/06/2024,152.26
18/06/2024,-20.8,DidiChuxing DIDI MOBIL Sydney AU AUS Card xx5077 Value Date: 14/06/2024,156.53
18/06/2024,-49.12,WOOLWORTHS 2865 WOOLLOONGABBA AU AUS Card xx5077 Value Date: 15/06/2024,177.33
18/06/2024,-8.56,UBER *TRIP Sydney AU AUS Card xx5077 Value Date: 16/06/2024,226.45
18/06/2024,-10.57,UBER *TRIP Sydney AU AUS Card xx5077 Value Date: 16/06/2024,235.01
18/06/2024,-16.46,UBER *TRIP Sydney AU AUS Card xx5077 Value Date: 15/06/2024,245.58
16/06/2024,100,Transfer from xx1056 CommBank app,262.04
15/06/2024,-12.15,DidiChuxing DIDI MOBIL Sydney AU AUS Card xx5077 Value Date: 13/06/2024,162.04
15/06/2024,-13.01,DidiChuxing DIDI MOBIL Sydney AU AUS Card xx5077 Value Date: 13/06/2024,174.19
15/06/2024,-6.99,APPLE.COM/BILL SYDNEY AU AUS Card xx5077 Value Date: 12/06/2024,187.2
15/06/2024,-16.8,HANE SUSHI WOOLLOONGABBA QL AUS Card xx5077 Value Date: 12/06/2024,194.19
15/06/2024,-114,Transfer to xx0713 NetBank My purchase goal,210.99
14/06/2024,-12.41,KENKO SUSHI HOUSE ST LUCIA AU AUS Card xx5077 Value Date: 12/06/2024,324.99
14/06/2024,-15,DidiChuxing DIDI MOBIL Sydney AU AUS Card xx5077 Value Date: 12/06/2024,337.4
13/06/2024,-48.1,DidiChuxing DIDI MOBIL Sydney AU AUS Card xx5077 Value Date: 11/06/2024,352.4
13/06/2024,-3.5,CantaloupeSystemsAustr Albion QL AUS Card xx5077 Value Date: 11/06/2024,400.5
13/06/2024,-1.17,International Transaction Fee Value Date: 10/06/2024,404
13/06/2024,-33.47,OPENAI SAN FRANCISCO CA USA Card xx5077 USD 22.00 Value Date: 11/06/2024,405.17
13/06/2024,-1.17,International Transaction Fee Value Date: 10/06/2024,438.64
13/06/2024,-33.47,OPENAI *CHATGPT SUBSCR SAN FRANCISCO CA USA Card xx5077 USD 22.00 Value Date: 11/06/2024,439.81
13/06/2024,-50.81,DidiChuxing DIDI MOBIL Sydney AU AUS Card xx5077 Value Date: 11/06/2024,473.28
12/06/2024,300,Fast Transfer From DEEKSHA ANAND Money,524.09
12/06/2024,-9.99,UBER *ONE Sydney AU AUS Card xx5077 Value Date: 10/06/2024,224.09
11/06/2024,100,Transfer from xx1056 CommBank app,234.08
11/06/2024,4,Transfer from xx0713 CommBank app,134.08
11/06/2024,100,Transfer from xx1056 CommBank app,130.08
11/06/2024,-287,OFFICEWORKS 0404 WOOLLOO AU AUS Card xx5077 Value Date: 07/06/2024,30.08
11/06/2024,-10.55,UBER *TRIP Sydney AU AUS Card xx5077 Value Date: 07/06/2024,317.08
11/06/2024,-72.01,MIRCHH MASALA IMPEX WOOLLOONGABBA AUS Card xx5077 Value Date: 06/06/2024,327.63
11/06/2024,-21.56,DidiChuxing DIDI MOBIL Sydney AU AUS Card xx5077 Value Date: 09/06/2024,399.64
11/06/2024,-52.46,UBER *EATS Sydney AU AUS Card xx5077 Value Date: 09/06/2024,421.2
09/06/2024,-63,ODIN PASS PTY LTD,473.66
09/06/2024,100,Transfer from xx1056 CommBank app,536.66
08/06/2024,-19,WOOLWORTHS 2865 WOOLLOONGABBA AU AUS Card xx5077 Value Date: 06/06/2024,436.66
08/06/2024,-26.15,WOOLWORTHS 2865 WOOLLOONGABBA AU AUS Card xx5077 Value Date: 06/06/2024,455.66
08/06/2024,-19.67,DidiChuxing DIDI MOBIL Sydney AU AUS Card xx5077 Value Date: 06/06/2024,481.81
08/06/2024,-5.3,BAR MERLO UQ BRISBANE QL AUS Card xx5077 Value Date: 05/06/2024,501.48
08/06/2024,-54.99,APPLE.COM/BILL SYDNEY NS AUS Card xx5077 Value Date: 06/06/2024,506.78
08/06/2024,-19.39,DidiChuxing DIDI MOBIL Sydney AU AUS Card xx5077 Value Date: 06/06/2024,561.77
07/06/2024,100,Transfer from xx1056 CommBank app,581.16
07/06/2024,200,Transfer from xx1056 CommBank app,481.16
07/06/2024,-4.27,KENKO SUSHI HOUSE ST LUCIA AU AUS Card xx5077 Value Date: 05/06/2024,281.16
07/06/2024,-26,GUZMAN Y GOMEZ SURRY HILLS NS AUS Card xx5077 Value Date: 05/06/2024,285.43
07/06/2024,-21.35,UBER* TRIP SYDNEY NS AUS Card xx5077 Value Date: 05/06/2024,311.43
07/06/2024,-17.15,ROLLING MAN TOOWONG QL AUS Card xx5077 Value Date: 04/06/2024,332.78
06/06/2024,-97.45,WOOLWORTHS 2865 WOOLLOONGABBA AU AUS Card xx5077 Value Date: 04/06/2024,349.93
06/06/2024,-54.99,TPG INTERNET PTY LTD MACQUARIE PAR NS AUS Card xx5077 Value Date: 03/06/2024,447.38
06/06/2024,-13.86,DidiChuxing DIDI MOBIL Sydney AU AUS Card xx5077 Value Date: 04/06/2024,502.37
06/06/2024,-20.3,DidiChuxing DIDI MOBIL Sydney AU AUS Card xx5077 Value Date: 04/06/2024,516.23
05/06/2024,-50,Dominos Estore Woolloo dominos.com.a AU AUS Card xx5077 Value Date: 03/06/2024,536.53
05/06/2024,-9.31,UBER* TRIP SYDNEY NS AUS Card xx5077 Value Date: 03/06/2024,586.53
05/06/2024,-9.36,UBER *TRIP Sydney AU AUS Card xx5077 Value Date: 03/06/2024,595.84
05/06/2024,-8.88,UBER *TRIP Sydney AU AUS Card xx5077 Value Date: 03/06/2024,605.2
05/06/2024,-9.36,UBER *TRIP Sydney AU AUS Card xx5077 Value Date: 03/06/2024,614.08
05/06/2024,-6.55,UBER *TRIP Sydney AU AUS Card xx5077 Value Date: 03/06/2024,623.44
05/06/2024,-24,CINEPLEX PARTNERSHIP SOUTH BRISBAN AUS Card xx5077 Value Date: 01/06/2024,629.99
05/06/2024,216.72,Salary ALH GROUP 236263,653.99
04/06/2024,200,Transfer from xx1056 CommBank app,437.27
04/06/2024,-55.68,UBER *EATS Sydney AU AUS Card xx5077 Value Date: 30/05/2024,237.27
04/06/2024,-54.5,DAN MURPHY'S 6979 WEST END AU AUS Card xx5077 Value Date: 01/06/2024,292.95
04/06/2024,-9.48,DidiChuxing DIDI MOBIL Sydney AU AUS Card xx5077 Value Date: 01/06/2024,347.45
04/06/2024,-26.4,ALH VENUES 8010 WEST END AU AUS Card xx5077 Value Date: 01/06/2024,356.93
04/06/2024,-5.1,DIGITALOCEAN.COM GROSVENOR PLA NS AUS Card xx5077 Value Date: 01/06/2024,383.33
04/06/2024,-53.75,UBER *EATS Sydney AU AUS Card xx5077 Value Date: 02/06/2024,388.43
03/06/2024,100,Transfer from xx1056 CommBank app,442.18
02/06/2024,110,Transfer from xx0713 CommBank app,342.18
02/06/2024,-8.7,Transfer To Michael Pinter CommBank App Food,232.18
01/06/2024,-0.04,Debit Excess Interest,240.88
01/06/2024,-200,Transfer to xx1056 CommBank app,240.92
01/06/2024,-500,Transfer to xx1056 CommBank app,440.92
01/06/2024,-114,Transfer to xx0713 NetBank My purchase goal,940.92
01/06/2024,-200,Transfer to xx1056 NetBank My emergency fund,1054.92
01/06/2024,-30.03,COCOS ANNERLEY ANNERLEY AU AUS Card xx5077 Value Date: 29/05/2024,1254.92
01/06/2024,-41.41,WOOLWORTHS 2614 BURANDA AU AUS Card xx5077 Value Date: 30/05/2024,1284.95
01/06/2024,-106.94,UBER *EATS Sydney AU AUS Card xx5077 Value Date: 30/05/2024,1326.36
31/05/2024,-13.85,IGA PULLENVALE PULLENVALE QL AUS Card xx5077 Value Date: 28/05/2024,1433.3
31/05/2024,-33.2,SQ *ORIGIN KEBAB BURAN Woolloongabba QL AUS Card xx5077 Value Date: 30/05/2024,1447.15
30/05/2024,-2.5,CantaloupeSystemsAustr Albion QL AUS Card xx5077 Value Date: 28/05/2024,1480.35
30/05/2024,-2.5,CantaloupeSystemsAustr Albion QL AUS Card xx5077 Value Date: 28/05/2024,1482.85
30/05/2024,-3.5,CantaloupeSystemsAustr Albion QL AUS Card xx5077 Value Date: 28/05/2024,1485.35
30/05/2024,-3,CantaloupeSystemsAustr Albion QL AUS Card xx5077 Value Date: 28/05/2024,1488.85
30/05/2024,-22.96,UBER *TRIP Sydney AU AUS Card xx5077 Value Date: 28/05/2024,1491.85
30/05/2024,3.5,Return CantaloupeSystemsAustr Albion QL AUS Card xx5077 Value Date: 28/05/2024,1514.81
29/05/2024,679.2,Salary UNI OF QLD 2263922 10712884,1511.31
29/05/2024,556.1,Salary UNI OF QLD 2263920 10712884,832.11
29/05/2024,-39,WOOLWORTHS 2614 BURANDA AU AUS Card xx5077 Value Date: 27/05/2024,276.01
29/05/2024,-5.8,LUV A COFFEE BURANDA BURANDA QL AUS Card xx5077 Value Date: 27/05/2024,315.01
29/05/2024,216.72,Salary ALH GROUP 236263,320.81
28/05/2024,-60,Transfer To A SHARMA PayID Phone from CommBank App Car ride,104.09
28/05/2024,-58.75,NANDOS BURANDA SC Buranda AU AUS Card xx5077 Value Date: 24/05/2024,164.09
28/05/2024,-10.2,GUZMAN Y GOMEZ SURRY HILLS NS AUS Card xx5077 Value Date: 24/05/2024,222.84
28/05/2024,-15.13,GOOGLE*COLAB CC GOOGLE.COM SG SGP Card xx5077 AUD 15.13 Value Date: 23/05/2024,233.04
28/05/2024,-21.59,UBER *TRIP Sydney AU AUS Card xx5077 Value Date: 24/05/2024,248.17
28/05/2024,-3.8,WOOLWORTHS 2705 WEST END AU AUS Card xx5077 Value Date: 25/05/2024,269.76
28/05/2024,-3.2,THE VENDING GUYS EAGLE FARM AU AUS Card xx5077 Value Date: 26/05/2024,273.56
28/05/2024,-3.1,THE VENDING GUYS EAGLE FARM AU AUS Card xx5077 Value Date: 26/05/2024,276.76
28/05/2024,-21.22,DidiChuxing DIDI MOBIL Sydney AU AUS Card xx5077 Value Date: 26/05/2024,279.86
28/05/2024,-59.94,UBER *EATS Sydney AU AUS Card xx5077 Value Date: 26/05/2024,301.08
28/05/2024,-51.19,UBER *EATS Sydney AU AUS Card xx5077 Value Date: 26/05/2024,361.02
28/05/2024,-19.76,UBER *TRIP Sydney AU AUS Card xx5077 Value Date: 26/05/2024,412.21
26/05/2024,200,Transfer from xx1056 CommBank app,431.97
26/05/2024,100,Transfer from xx1056 CommBank app,231.97
25/05/2024,-10,Transfer To Michael Pinter CommBank App Cash out,131.97
25/05/2024,-50,Transfer To Michael Pinter CommBank App Cash out,141.97
25/05/2024,100,Transfer from xx1056 CommBank app,191.97
25/05/2024,-15.12,ORIENTAL CORNER St Lucia AU AUS Card xx5077 Value Date: 23/05/2024,91.97
25/05/2024,-19.27,UBER *TRIP Sydney AU AUS Card xx5077 Value Date: 23/05/2024,107.09
25/05/2024,-20.78,UBER *TRIP Sydney AU AUS Card xx5077 Value Date: 23/05/2024,126.36
25/05/2024,-31.95,CABOOLTURE SUSHI PTY L WOOLLOONGABBA AUS Card xx5077 Value Date: 23/05/2024,147.14
24/05/2024,-2.99,APPLE.COM/BILL SYDNEY NS AUS Card xx5077 Value Date: 22/05/2024,179.09
24/05/2024,-21.47,UBER *TRIP Sydney AU AUS Card xx5077 Value Date: 22/05/2024,182.08
24/05/2024,-20.85,UBER *TRIP Sydney AU AUS Card xx5077 Value Date: 22/05/2024,203.55
24/05/2024,-19.48,DidiChuxing DIDI MOBIL Sydney AU AUS Card xx5077 Value Date: 22/05/2024,224.4
24/05/2024,-19.16,DidiChuxing DIDI MOBIL Sydney AU AUS Card xx5077 Value Date: 21/05/2024,243.88
24/05/2024,-15,LAKESIDE ENTERPRISEQPS UNIVERSITY OF AUS Card xx5077 Value Date: 22/05/2024,263.04
24/05/2024,-39.13,CABOOLTURE SUSHI PTY L WOOLLOONGABBA AUS Card xx5077 Value Date: 22/05/2024,278.04
23/05/2024,100,Transfer from xx1056 CommBank app,317.17
23/05/2024,-19.95,UPDOC.COM.AU -KNPAGPWR,217.17
22/05/2024,200,Transfer from xx1056 CommBank app,237.12
22/05/2024,-15.12,ORIENTAL CORNER St Lucia AU AUS Card xx5077 Value Date: 20/05/2024,37.12
22/05/2024,-11.83,WOOLWORTHS 2614 BURANDA AU AUS Card xx5077 Value Date: 20/05/2024,52.24
22/05/2024,-10.4,Guzman y Gomez St Lucia QL AUS Card xx5077 Value Date: 20/05/2024,64.07
22/05/2024,-9.3,STARBUCKS COFFEE D00 WOOLLOONGABBA QL AUS Card xx5077 Value Date: 19/05/2024,74.47
22/05/2024,-19.12,UBER *TRIP Sydney AU AUS Card xx5077 Value Date: 20/05/2024,83.77
22/05/2024,-5.5,VIETNAMESE OVEN WOOLLOONGABBA QL AUS Card xx5077 Value Date: 20/05/2024,102.89
22/05/2024,-4.99,BURANDA PL & BURANDQPS BURANDA AUS Card xx5077 Value Date: 20/05/2024,108.39
22/05/2024,-2.99,BURANDA PL & BURANDQPS BURANDA AUS Card xx5077 Value Date: 20/05/2024,113.38
21/05/2024,-18.17,ORIENTAL CORNER St Lucia AU AUS Card xx5077 Value Date: 17/05/2024,116.37
21/05/2024,-61.17,UBER* EATS SYDNEY NS AUS Card xx5077 Value Date: 17/05/2024,134.54
21/05/2024,-21.98,UBER *TRIP Sydney AU AUS Card xx5077 Value Date: 17/05/2024,195.71
21/05/2024,-58.7,DidiChuxing DIDI MOBIL Sydney AU AUS Card xx5077 Value Date: 18/05/2024,217.69
21/05/2024,-18.28,COCOS ANNERLEY ANNERLEY AU AUS Card xx5077 Value Date: 17/05/2024,276.39
21/05/2024,-9,SQ *PRIMA North Lakes QL AUS Card xx5077 Value Date: 18/05/2024,294.67
21/05/2024,-18,SQ *PRIMA North Lakes QL AUS Card xx5077 Value Date: 18/05/2024,303.67
21/05/2024,-13.17,DidiChuxing DIDI MOBIL Sydney AU AUS Card xx5077 Value Date: 18/05/2024,321.67
21/05/2024,-53.34,DidiChuxing DIDI MOBIL Sydney AU AUS Card xx5077 Value Date: 18/05/2024,334.84
21/05/2024,-112.15,TARGET 5059 BURANDA AU AUS Card xx5077 Value Date: 18/05/2024,388.18
21/05/2024,-114.6,MARU KOREAN BBQ Brisbane QL AUS Card xx5077 Value Date: 18/05/2024,500.33
21/05/2024,-12,CEX PTY LTD BRISBANE CITY AUS Card xx5077 Value Date: 18/05/2024,614.93
21/05/2024,-20.51,DidiChuxing DIDI MOBIL Sydney AU AUS Card xx5077 Value Date: 19/05/2024,626.93
21/05/2024,-20.35,UBER *TRIP Sydney AU AUS Card xx5077 Value Date: 19/05/2024,647.44
21/05/2024,-8.17,UBER *TRIP Sydney AU AUS Card xx5077 Value Date: 18/05/2024,667.79
21/05/2024,-6.56,UBER *TRIP Sydney AU AUS Card xx5077 Value Date: 18/05/2024,675.96
20/05/2024,-200,Transfer to xx1056 CommBank app,682.52
20/05/2024,-1890,Transfer To Deeksha CommBank App House,882.52
20/05/2024,2000,Transfer from xx1056 CommBank app,2772.52
20/05/2024,200,Transfer from xx1056 CommBank app,772.52
18/05/2024,20,Fast Transfer From HARRY BROXHAM Chauffeur fee,572.52
18/05/2024,100,Transfer from xx0713 CommBank app,552.52
18/05/2024,40,Fast Transfer From HARRY BROXHAM Chicken fee,452.52
18/05/2024,100,Transfer from xx0713 CommBank app,412.52
18/05/2024,150,Transfer from xx0713 CommBank app,312.52
18/05/2024,-15.12,ORIENTAL CORNER St Lucia AU AUS Card xx5077 Value Date: 16/05/2024,162.52
18/05/2024,-12.52,KENKO SUSHI HOUSE ST LUCIA AU AUS Card xx5077 Value Date: 16/05/2024,177.64
18/05/2024,-8.7,Chatime UQ St Lucia St Lucia QL AUS Card xx5077 Value Date: 16/05/2024,190.16
18/05/2024,-19.16,DidiChuxing DIDI MOBIL Sydney AU AUS Card xx5077 Value Date: 16/05/2024,198.86
17/05/2024,-13.9,ORIENTAL CORNER St Lucia AU AUS Card xx5077 Value Date: 15/05/2024,218.02
16/05/2024,-39.77,DidiChuxing DIDI MOBIL Sydney AU AUS Card xx5077 Value Date: 14/05/2024,231.92
16/05/2024,-45.05,DidiChuxing DIDI MOBIL Sydney AU AUS Card xx5077 Value Date: 14/05/2024,271.69
16/05/2024,-20.69,DidiChuxing DIDI MOBIL Sydney AU AUS Card xx5077 Value Date: 14/05/2024,316.74
15/05/2024,-100,Transfer to xx0713 CommBank app,337.43
15/05/2024,-250,Transfer to xx0713 CommBank app,437.43
15/05/2024,-1000,Transfer to xx1056 CommBank app,687.43
15/05/2024,-15.12,ORIENTAL CORNER St Lucia AU AUS Card xx5077 Value Date: 13/05/2024,1687.43
15/05/2024,-8,LAT*AnnerleyLaundro Annerley AU AUS Card xx5077 Value Date: 12/05/2024,1702.55
15/05/2024,-4,LAT*AnnerleyLaundro Annerley AU AUS Card xx5077 Value Date: 12/05/2024,1710.55
15/05/2024,-10,LAT*AnnerleyLaundro Annerley AU AUS Card xx5077 Value Date: 12/05/2024,1714.55
15/05/2024,-113.42,WOOLWORTHS 2614 BURANDA AU AUS Card xx5077 Value Date: 13/05/2024,1724.55
15/05/2024,-19.88,DidiChuxing DIDI MOBIL Sydney AU AUS Card xx5077 Value Date: 13/05/2024,1837.97
15/05/2024,693.2,Salary UNI OF QLD 2263922 10712884,1857.85
15/05/2024,377.4,Salary UNI OF QLD 2263920 10712884,1164.65
15/05/2024,370.69,Salary ALH GROUP 236263,787.25
14/05/2024,200,Transfer from xx1056 CommBank app,416.56
14/05/2024,-15.12,ORIENTAL CORNER St Lucia AU AUS Card xx5077 Value Date: 10/05/2024,216.56
14/05/2024,-33.49,DAN MURPHY'S 6979 WEST END AU AUS Card xx5077 Value Date: 10/05/2024,231.68
14/05/2024,-9.99,UBER *ONE Sydney AU AUS Card xx5077 Value Date: 10/05/2024,265.17
14/05/2024,-8.65,UBER* TRIP SYDNEY NS AUS Card xx5077 Value Date: 10/05/2024,275.16
14/05/2024,-23.4,ALH VENUES 8010 WEST END AU AUS Card xx5077 Value Date: 11/05/2024,283.81
14/05/2024,-6.99,APPLE.COM/BILL SYDNEY NS AUS Card xx5077 Value Date: 11/05/2024,307.21
14/05/2024,-7.12,UBER* TRIP SYDNEY NS AUS Card xx5077 Value Date: 11/05/2024,314.2
14/05/2024,-7.6,Le Boulangerie Amour Woolloongabba QL AUS Card xx5077 Value Date: 11/05/2024,321.32
14/05/2024,-101.19,WOOLWORTHS 2614 BURANDA AU AUS Card xx5077 Value Date: 12/05/2024,328.92
14/05/2024,-67.13,UBER *EATS Sydney AU AUS Card xx5077 Value Date: 12/05/2024,430.11
14/05/2024,-9.36,UBER *TRIP Sydney AU AUS Card xx5077 Value Date: 11/05/2024,497.24
14/05/2024,-10.33,UBER *TRIP Sydney AU AUS Card xx5077 Value Date: 11/05/2024,506.6
14/05/2024,-11.52,UBER *TRIP Sydney AU AUS Card xx5077 Value Date: 11/05/2024,516.93
14/05/2024,-7,UBER *TRIP Sydney AU AUS Card xx5077 Value Date: 11/05/2024,528.45
14/05/2024,-19.16,DidiChuxing DIDI MOBIL Sydney AU AUS Card xx5077 Value Date: 12/05/2024,535.45
13/05/2024,200,Transfer from xx1056 CommBank app,554.61
12/05/2024,100,Transfer from xx1056 CommBank app,354.61
11/05/2024,100,Transfer from xx1056 CommBank app,254.61
11/05/2024,-51.9,NANDOS BURANDA SC Buranda AU AUS Card xx5077 Value Date: 09/05/2024,154.61
11/05/2024,-20.16,DidiChuxing DIDI MOBIL Sydney AU AUS Card xx5077 Value Date: 09/05/2024,206.51
11/05/2024,-20.37,DidiChuxing DIDI MOBIL Sydney AU AUS Card xx5077 Value Date: 09/05/2024,226.67
11/05/2024,-8.24,KENKO SUSHI HOUSE ST LUCIA AU AUS Card xx5077 Value Date: 09/05/2024,247.04
11/05/2024,-12.52,KENKO SUSHI HOUSE ST LUCIA AU AUS Card xx5077 Value Date: 09/05/2024,255.28
11/05/2024,-54.99,APPLE.COM/BILL SYDNEY AU AUS Card xx5077 Value Date: 08/05/2024,267.8
11/05/2024,-63.39,UBER *EATS Sydney AU AUS Card xx5077 Value Date: 09/05/2024,322.79
11/05/2024,-19.17,DidiChuxing DIDI MOBIL Sydney AU AUS Card xx5077 Value Date: 09/05/2024,386.18
10/05/2024,100,Transfer from xx1056 CommBank app,405.35
10/05/2024,-3.7,CantaloupeSystemsAustr Albion QL AUS Card xx5077 Value Date: 08/05/2024,305.35
10/05/2024,-16.02,IGA PULLENVALE PULLENVALE QL AUS Card xx5077 Value Date: 07/05/2024,309.05
10/05/2024,-63,ODIN PASS PTY LTD BRISBANE CITY QL AUS Card xx5077 Value Date: 08/05/2024,325.07
10/05/2024,-22.95,DidiChuxing DIDI MOBIL Sydney AU AUS Card xx5077 Value Date: 07/05/2024,388.07
10/05/2024,-19.26,DidiChuxing DIDI MOBIL Sydney AU AUS Card xx5077 Value Date: 08/05/2024,411.02
09/05/2024,100,Transfer from xx1056 CommBank app,430.28
09/05/2024,100,Transfer from xx1056 CommBank app,330.28
09/05/2024,-17.94,APPLE.COM/BILL SYDNEY AU AUS Card xx5077 Value Date: 06/05/2024,230.28
09/05/2024,-66.9,UBER *EATS Sydney AU AUS Card xx5077 Value Date: 06/05/2024,248.22
09/05/2024,-18.33,UBER *TRIP Sydney AU AUS Card xx5077 Value Date: 07/05/2024,315.12
09/05/2024,-31.93,UBER *TRIP Sydney AU AUS Card xx5077 Value Date: 07/05/2024,333.45
08/05/2024,-200,Transfer to xx1056 NetBank My emergency fund,365.38
08/05/2024,-69.19,UBER *EATS Sydney AU AUS Card xx5077 Value Date: 05/05/2024,565.38
08/05/2024,-19.77,DidiChuxing DIDI MOBIL Sydney AU AUS Card xx5077 Value Date: 06/05/2024,634.57
08/05/2024,216.72,Salary ALH GROUP 236263,654.34
07/05/2024,200,Transfer from xx1056 CommBank app,437.62
07/05/2024,-15,Overdraw Fee For exceeding available funds on 06 May,237.62
07/05/2024,164,Transfer from xx0713 CommBank app,252.62
07/05/2024,-4,LAT*AnnerleyLaundro Annerley AU AUS Card xx5077 Value Date: 02/05/2024,88.62
07/05/2024,-6,LAT*AnnerleyLaundro Annerley AU AUS Card xx5077 Value Date: 02/05/2024,92.62
07/05/2024,-5,LAT*AnnerleyLaundro Annerley AU AUS Card xx5077 Value Date: 02/05/2024,98.62
07/05/2024,-12.52,KENKO SUSHI HOUSE ST LUCIA AU AUS Card xx5077 Value Date: 03/05/2024,103.62
07/05/2024,-20.91,DidiChuxing DIDI MOBIL Sydney AU AUS Card xx5077 Value Date: 03/05/2024,116.14
07/05/2024,-22.21,DidiChuxing DIDI MOBIL Sydney AU AUS Card xx5077 Value Date: 03/05/2024,137.05
07/05/2024,-7.76,UBER *EATS Sydney AU AUS Card xx5077 Value Date: 02/05/2024,159.26
07/05/2024,-9.51,DidiChuxing DIDI MOBIL Sydney AU AUS Card xx5077 Value Date: 04/05/2024,167.02
07/05/2024,-22.7,STARBUCKS COFFEE D00 WOOLLOONGABBA QL AUS Card xx5077 Value Date: 03/05/2024,176.53
07/05/2024,-53.64,UBER *EATS Sydney AU AUS Card xx5077 Value Date: 04/05/2024,199.23
07/05/2024,-76.32,UBER *EATS Sydney AU AUS Card xx5077 Value Date: 05/05/2024,252.87
07/05/2024,-119.7,UBER *EATS Sydney AU AUS Card xx5077 Value Date: 03/05/2024,329.19
07/05/2024,-12.62,UBER *TRIP Sydney AU AUS Card xx5077 Value Date: 05/05/2024,448.89
07/05/2024,-13.61,UBER *TRIP Sydney AU AUS Card xx5077 Value Date: 04/05/2024,461.51
05/05/2024,50,Transfer from xx0713 CommBank app,475.12
04/05/2024,200,Transfer from xx0713 CommBank app,425.12
04/05/2024,-114,Transfer to xx0713 NetBank My purchase goal,225.12
04/05/2024,-5.98,APPLE.COM/BILL SYDNEY NS AUS Card xx5077 Value Date: 01/05/2024,339.12
04/05/2024,-43.57,UBER *EATS Sydney AU AUS Card xx5077 Value Date: 02/05/2024,345.1
04/05/2024,-87.75,UBER *EATS Sydney AU AUS Card xx5077 Value Date: 02/05/2024,388.67
04/05/2024,-24.65,UBER *TRIP Sydney AU AUS Card xx5077 Value Date: 02/05/2024,476.42
04/05/2024,-19.16,DidiChuxing DIDI MOBIL Sydney AU AUS Card xx5077 Value Date: 02/05/2024,501.07
03/05/2024,146,Transfer from xx0713 CommBank app,520.23
03/05/2024,-18.98,ORIENTAL CORNER St Lucia AU AUS Card xx5077 Value Date: 01/05/2024,374.23
03/05/2024,-9.06,KENKO SUSHI HOUSE ST LUCIA AU AUS Card xx5077 Value Date: 01/05/2024,393.21
03/05/2024,-8.97,APPLE.COM/BILL SYDNEY AU AUS Card xx5077 Value Date: 30/04/2024,402.27
02/05/2024,200,Transfer from xx0713 CommBank app,411.24
02/05/2024,-46.8,DidiChuxing DIDI MOBIL Sydney AU AUS Card xx5077 Value Date: 30/04/2024,211.24
02/05/2024,-3.5,CantaloupeSystemsAustr Albion QL AUS Card xx5077 Value Date: 30/04/2024,258.04
02/05/2024,-2.5,CantaloupeSystemsAustr Albion QL AUS Card xx5077 Value Date: 30/04/2024,261.54
02/05/2024,-2.5,CantaloupeSystemsAustr Albion QL AUS Card xx5077 Value Date: 30/04/2024,264.04
02/05/2024,-33.21,UBER *TRIP Sydney AU AUS Card xx5077 Value Date: 30/04/2024,266.54
01/05/2024,-640,Transfer to xx0713 CommBank app,299.75
01/05/2024,-1000,Transfer to xx1056 CommBank app,939.75
01/05/2024,-0.03,Debit Excess Interest,1939.75
01/05/2024,834.58,Salary UNI OF QLD 2263922 10712884,1939.78
01/05/2024,1022.18,Salary UNI OF QLD 2263920 10712884,1105.2
01/05/2024,-30.4,GUZMAN Y GOMEZ SURRY HILLS NS AUS Card xx5077 Value Date: 29/04/2024,83.02
01/05/2024,-23.3,VIETNAMESE OVEN WOOLLOONGABBA QL AUS Card xx5077 Value Date: 27/04/2024,113.42
30/04/2024,-21.06,KENKO SUSHI HOUSE ST LUCIA AU AUS Card xx5077 Value Date: 26/04/2024,136.72
30/04/2024,-6.7,CantaloupeSystemsAustr Albion QL AUS Card xx5077 Value Date: 26/04/2024,157.78
30/04/2024,-3.25,CantaloupeSystemsAustr Albion QL AUS Card xx5077 Value Date: 26/04/2024,164.48
30/04/2024,-15.17,UBER *TRIP Sydney AU AUS Card xx5077 Value Date: 26/04/2024,167.73
30/04/2024,-5.7,WOOLWORTHS 2614 BURANDA AU AUS Card xx5077 Value Date: 27/04/2024,182.9
30/04/2024,-1.65,ORDER NOW* MOMO CHICKE EIGHT MILES P QL AUS Card xx5077 Value Date: 27/04/2024,188.6
30/04/2024,-68.8,ORDER NOW* MOMO CHICKE EIGHT MILES P QL AUS Card xx5077 Value Date: 27/04/2024,190.25
30/04/2024,-18.85,UBER* TRIP SYDNEY NS AUS Card xx5077 Value Date: 27/04/2024,259.05
30/04/2024,-32,R.J BARBER WOOLLOONGABBA AUS Card xx5077 Value Date: 27/04/2024,277.9
30/04/2024,-13.93,UBER *TRIP Sydney AU AUS Card xx5077 Value Date: 28/04/2024,309.9
30/04/2024,-22.5,DidiChuxing DIDI MOBIL Sydney AU AUS Card xx5077 Value Date: 29/04/2024,323.83
30/04/2024,-34.8,EVENT CINEMAS BRISBA BRISBANE AUS Card xx5077 Value Date: 27/04/2024,346.33
27/04/2024,200,Transfer from xx1056 CommBank app,381.13
27/04/2024,-18.98,ORIENTAL CORNER St Lucia AU AUS Card xx5077 Value Date: 24/04/2024,181.13
27/04/2024,-18.62,UBER *EATS Sydney AU AUS Card xx5077 Value Date: 24/04/2024,200.11
27/04/2024,-12.75,CantaloupeSystemsAustr Albion QL AUS Card xx5077 Value Date: 25/04/2024,218.73
27/04/2024,-21.16,GUZMAN Y GOMEZ SURRY HILLS NS AUS Card xx5077 Value Date: 25/04/2024,231.48
27/04/2024,-32.2,STARBUCKS COFFEE D00 WOOLLOONGABBA QL AUS Card xx5077 Value Date: 24/04/2024,252.64
27/04/2024,-57.05,UBER *EATS Sydney AU AUS Card xx5077 Value Date: 25/04/2024,284.84
27/04/2024,-78.14,UBER *EATS Sydney AU AUS Card xx5077 Value Date: 24/04/2024,341.89
27/04/2024,-2.72,UBER *TRIP Sydney AU AUS Card xx5077 Value Date: 25/04/2024,420.03
27/04/2024,-15.05,UBER* TRIP SYDNEY NS AUS Card xx5077 Value Date: 25/04/2024,422.75
27/04/2024,2.5,Return CantaloupeSystemsAustr Albion QL AUS Card xx5077 Value Date: 24/04/2024,437.8
26/04/2024,250,Transfer from xx1056 CommBank app,435.3
25/04/2024,-2.5,CantaloupeSystemsAustr Albion QL AUS Card xx5077 Value Date: 23/04/2024,185.3
25/04/2024,-3.5,CantaloupeSystemsAustr Albion QL AUS Card xx5077 Value Date: 23/04/2024,187.8
25/04/2024,-2.8,CantaloupeSystemsAustr Albion QL AUS Card xx5077 Value Date: 23/04/2024,191.3
25/04/2024,-2.5,CantaloupeSystemsAustr Albion QL AUS Card xx5077 Value Date: 23/04/2024,194.1
25/04/2024,-22.5,GUZMAN Y GOMEZ SURRY HILLS NS AUS Card xx5077 Value Date: 23/04/2024,196.6
25/04/2024,-57.1,UBER *EATS Sydney AU AUS Card xx5077 Value Date: 23/04/2024,219.1
25/04/2024,-55.35,UBER *TRIP Sydney AU AUS Card xx5077 Value Date: 23/04/2024,276.2
25/04/2024,-22.1,VIETNAMESE OVEN WOOLLOONGABBA QL AUS Card xx5077 Value Date: 23/04/2024,331.55
24/04/2024,-15.12,ORIENTAL CORNER St Lucia AU AUS Card xx5077 Value Date: 22/04/2024,353.65
24/04/2024,-64.78,UBER* EATS SYDNEY NS AUS Card xx5077 Value Date: 22/04/2024,368.77
24/04/2024,-8.55,KENKO SUSHI HOUSE ST LUCIA AU AUS Card xx5077 Value Date: 22/04/2024,433.55
24/04/2024,-79.9,BIRYANI PLACE SOUTH BRISBAN QL AUS Card xx5077 Value Date: 19/04/2024,442.1
24/04/2024,-7.83,UBER *TRIP Sydney AU AUS Card xx5077 Value Date: 22/04/2024,522
24/04/2024,-6.29,UBER *TRIP Sydney AU AUS Card xx5077 Value Date: 22/04/2024,529.83
24/04/2024,-14.76,UBER *TRIP Sydney AU AUS Card xx5077 Value Date: 22/04/2024,536.12
24/04/2024,-5.79,UBER *TRIP Sydney AU AUS Card xx5077 Value Date: 22/04/2024,550.88
24/04/2024,-6.49,UBER *TRIP Sydney AU AUS Card xx5077 Value Date: 22/04/2024,556.67
24/04/2024,-10.17,UBER *TRIP Sydney AU AUS Card xx5077 Value Date: 22/04/2024,563.16
24/04/2024,180.6,Salary ALH GROUP 236263,573.33
23/04/2024,110,Transfer from xx0713 CommBank app,392.73
23/04/2024,-4,LAT*AnnerleyLaundro Annerley AU AUS Card xx5077 Value Date: 18/04/2024,282.73
23/04/2024,-9,LAT*AnnerleyLaundro Annerley AU AUS Card xx5077 Value Date: 18/04/2024,286.73
23/04/2024,-9,LAT*AnnerleyLaundro Annerley AU AUS Card xx5077 Value Date: 18/04/2024,295.73
23/04/2024,-4,LAT*AnnerleyLaundro Annerley AU AUS Card xx5077 Value Date: 18/04/2024,304.73
23/04/2024,-6.75,WOOLWORTHS 2614 BURANDA AU AUS Card xx5077 Value Date: 19/04/2024,308.73
23/04/2024,-72.69,UBER *EATS Sydney AU AUS Card xx5077 Value Date: 18/04/2024,315.48
23/04/2024,-15.92,UBER *EATS Sydney AU AUS Card xx5077 Value Date: 19/04/2024,388.17
23/04/2024,-9.52,UBER *TRIP Sydney AU AUS Card xx5077 Value Date: 19/04/2024,404.09
23/04/2024,-7.94,UBER *TRIP Sydney AU AUS Card xx5077 Value Date: 19/04/2024,413.61
23/04/2024,-10.08,UBER *TRIP Sydney AU AUS Card xx5077 Value Date: 19/04/2024,421.55
23/04/2024,-9.75,UBER *TRIP Sydney AU AUS Card xx5077 Value Date: 19/04/2024,431.63
23/04/2024,-6.5,LAKESIDE ENTERPRISEQPS UNIVERSITY OF AUS Card xx5077 Value Date: 19/04/2024,441.38
23/04/2024,-14.44,WOOLWORTHS 2705 WEST END AU AUS Card xx5077 Value Date: 20/04/2024,447.88
23/04/2024,-27.9,DidiChuxing DIDI MOBIL Sydney AU AUS Card xx5077 Value Date: 20/04/2024,462.32
23/04/2024,-7.88,UBER* TRIP SYDNEY NS AUS Card xx5077 Value Date: 20/04/2024,490.22
23/04/2024,-30.9,STARBUCKS COFFEE D00 WOOLLOONGABBA QL AUS Card xx5077 Value Date: 19/04/2024,498.1
23/04/2024,-29.9,APPLE.COM/BILL SYDNEY AU AUS Card xx5077 Value Date: 20/04/2024,529
23/04/2024,-83.34,UBER *EATS Sydney AU AUS Card xx5077 Value Date: 20/04/2024,558.9
23/04/2024,-7.3,UBER *TRIP Sydney AU AUS Card xx5077 Value Date: 20/04/2024,642.24
23/04/2024,-10.29,UBER *TRIP Sydney AU AUS Card xx5077 Value Date: 20/04/2024,649.54
23/04/2024,-114,Transfer to xx0713 NetBank My purchase goal,659.83
22/04/2024,-22,Transfer To Deeksha CommBank App Food,773.83
22/04/2024,200,Transfer from xx1056 CommBank app,795.83
20/04/2024,200,Transfer from xx1056 CommBank app,595.83
20/04/2024,-34.65,UBER *EATS Sydney AU AUS Card xx5077 Value Date: 17/04/2024,395.83
20/04/2024,-26.55,UBER *EATS Sydney AU AUS Card xx5077 Value Date: 17/04/2024,430.48
19/04/2024,-3.7,CantaloupeSystemsAustr Albion QL AUS Card xx5077 Value Date: 17/04/2024,457.03
19/04/2024,-21.27,KENKO SUSHI HOUSE ST LUCIA AU AUS Card xx5077 Value Date: 17/04/2024,460.73
18/04/2024,300,Transfer from xx1056 CommBank app,482
18/04/2024,-21.65,Subway University of Q St Lucia QL AUS Card xx5077 Value Date: 15/04/2024,182
17/04/2024,-101.9,Voco Gold Coast OPI Surfers Parad QL AUS Card xx5077 Value Date: 14/04/2024,203.65
17/04/2024,-6.48,DidiChuxing DIDI MOBIL Sydney AU AUS Card xx5077 Value Date: 15/04/2024,305.55
17/04/2024,-24,IKEA PTY LTD TEmpe NS AUS Card xx5077 Value Date: 14/04/2024,312.03
17/04/2024,-7.5,IKEA PTY LTD TEmpe NS AUS Card xx5077 Value Date: 14/04/2024,336.03
17/04/2024,-36,GUZMAN Y GOMEZ SURRY HILLS NS AUS Card xx5077 Value Date: 14/04/2024,343.53
17/04/2024,-116.15,ALFRESCO ON ELSTON SURFERS PARAD QL AUS Card xx5077 Value Date: 12/04/2024,379.53
17/04/2024,-203.45,ALLY FASHION SURFERS PARAD QL AUS Card xx5077 Value Date: 13/04/2024,495.68
17/04/2024,-19.27,DidiChuxing DIDI MOBIL Sydney AU AUS Card xx5077 Value Date: 15/04/2024,699.13
16/04/2024,-249,Hotel at Booking.com Sydney AU AUS Card xx5077 Value Date: 12/04/2024,718.4
16/04/2024,-6.99,APPLE.COM/BILL SYDNEY AU AUS Card xx5077 Value Date: 11/04/2024,967.4
16/04/2024,-7.57,NAYER AND NASIM FAMILY HELENSVALE AUS Card xx5077 Value Date: 12/04/2024,974.39
16/04/2024,-5.05,NAYER AND NASIM FAMILY HELENSVALE AUS Card xx5077 Value Date: 12/04/2024,981.96
16/04/2024,-10.59,NAYER AND NASIM FAMILY HELENSVALE AUS Card xx5077 Value Date: 12/04/2024,987.01
16/04/2024,-16,SQ *AMBER AND HUE Surfers Parad QL AUS Card xx5077 Value Date: 13/04/2024,997.6
16/04/2024,-7.98,SQ *GONG CHA SURFERS P Surfers Parad QL AUS Card xx5077 Value Date: 13/04/2024,1013.6
16/04/2024,-50,SQ *GOOD INTENTIONS CO Surfers Parad QL AUS Card xx5077 Value Date: 13/04/2024,1021.58
16/04/2024,-60.95,SQ *CRAZY CAT CAFE Surfers Parad QL AUS Card xx5077 Value Date: 13/04/2024,1071.58
16/04/2024,-5.06,COASTAL DISCOUNTS PTY Surfers Parad QL AUS Card xx5077 Value Date: 13/04/2024,1132.53
16/04/2024,-52.66,COASTAL DISCOUNTS PTY Surfers Parad QL AUS Card xx5077 Value Date: 13/04/2024,1137.59
16/04/2024,-50.95,Voco Gold Coast OPI Surfers Parad QL AUS Card xx5077 Value Date: 13/04/2024,1190.25
16/04/2024,-24.34,GC KEBABS PTY LTD SURFERS PARAD AU AUS Card xx5077 Value Date: 13/04/2024,1241.2
16/04/2024,-6.1,SQ *PIXIES TROPICAL SN South Brisban QL AUS Card xx5077 Value Date: 14/04/2024,1265.54
16/04/2024,-12.17,SQ *PIXIES TROPICAL SN South Brisban QL AUS Card xx5077 Value Date: 14/04/2024,1271.64
16/04/2024,-58.32,INFINITY GOLDCOAST SURFERS PARAD QL AUS Card xx5077 Value Date: 13/04/2024,1283.81
14/04/2024,200,Transfer from xx1056 CommBank app,1342.13
13/04/2024,300,Transfer from xx1056 CommBank app,1142.13
13/04/2024,250,Transfer from xx1056 CommBank app,842.13
13/04/2024,-320,Transfer To Deeksha CommBank App Gratitude,592.13
13/04/2024,300,Transfer from xx1056 CommBank app,912.13
13/04/2024,-15.12,ORIENTAL CORNER St Lucia AU AUS Card xx5077 Value Date: 11/04/2024,612.13
13/04/2024,-25.42,WOOLWORTHS 2614 BURANDA AU AUS Card xx5077 Value Date: 11/04/2024,627.25
13/04/2024,-3.7,CantaloupeSystemsAustr Albion QL AUS Card xx5077 Value Date: 11/04/2024,652.67
13/04/2024,-14.29,UBER *TRIP Sydney AU AUS Card xx5077 Value Date: 11/04/2024,656.37
13/04/2024,-30.98,MCDONALDS ANNERLEY ANNERLEY AUS Card xx5077 Value Date: 10/04/2024,670.66
12/04/2024,500,Transfer from xx1056 CommBank app,701.64
12/04/2024,20,Transfer from xx0713 CommBank app,201.64
12/04/2024,-4,LAT*AnnerleyLaundro Annerley AU AUS Card xx5077 Value Date: 10/04/2024,181.64
12/04/2024,-5,LAT*AnnerleyLaundro Annerley AU AUS Card xx5077 Value Date: 10/04/2024,185.64
12/04/2024,-17.29,UBER *TRIP Sydney AU AUS Card xx5077 Value Date: 10/04/2024,190.64
12/04/2024,-14.27,UBER *TRIP Sydney AU AUS Card xx5077 Value Date: 10/04/2024,207.93
12/04/2024,-9.99,UBER *ONE Sydney AU AUS Card xx5077 Value Date: 10/04/2024,222.2
11/04/2024,-2.6,CantaloupeSystemsAustr Albion QL AUS Card xx5077 Value Date: 09/04/2024,232.19
11/04/2024,-3.5,CantaloupeSystemsAustr Albion QL AUS Card xx5077 Value Date: 09/04/2024,234.79
11/04/2024,-15.1,STARBUCKS COFFEE D00 WOOLLOONGABBA QL AUS Card xx5077 Value Date: 08/04/2024,238.29
11/04/2024,-6.8,STARBUCKS COFFEE D00 WOOLLOONGABBA QL AUS Card xx5077 Value Date: 08/04/2024,253.39
11/04/2024,-25.22,UBER *EATS Sydney AU AUS Card xx5077 Value Date: 09/04/2024,260.19
11/04/2024,-21.11,UBER *TRIP Sydney AU AUS Card xx5077 Value Date: 09/04/2024,285.41
11/04/2024,-13.67,UBER* TRIP SYDNEY NS AUS Card xx5077 Value Date: 09/04/2024,306.52
10/04/2024,0.13,Direct Credit 617703 PAYPAL AUSTRALIA 1033674897039,320.19
10/04/2024,0.15,Direct Credit 617703 PAYPAL AUSTRALIA 1033674897035,320.06
10/04/2024,-150,Transfer To Rafael CommBank App Rent,319.91
10/04/2024,200,Transfer from xx1056 CommBank app,469.91
10/04/2024,-200,Transfer to xx1056 NetBank My emergency fund,269.91
10/04/2024,-31.35,UBER *EATS Sydney AU AUS Card xx5077 Value Date: 08/04/2024,469.91
10/04/2024,-16.29,UBER *TRIP Sydney AU AUS Card xx5077 Value Date: 08/04/2024,501.26
10/04/2024,-14.24,UBER *TRIP Sydney AU AUS Card xx5077 Value Date: 08/04/2024,517.55
10/04/2024,-42.86,DidiChuxing DIDI MOBIL Sydney AU AUS Card xx5077 Value Date: 09/04/2024,531.79
10/04/2024,216.72,Salary ALH GROUP 236263,574.65
09/04/2024,-10.78,DidiChuxing DIDI MOBIL Sydney AU AUS Card xx5077 Value Date: 05/04/2024,357.93
09/04/2024,-21.13,UBER *TRIP Sydney AU AUS Card xx5077 Value Date: 05/04/2024,368.71
09/04/2024,-10.13,DidiChuxing DIDI MOBIL Sydney AU AUS Card xx5077 Value Date: 06/04/2024,389.84
09/04/2024,-23.4,ALH VENUES 8010 WEST END AU AUS Card xx5077 Value Date: 06/04/2024,399.97
09/04/2024,-10.14,DidiChuxing DIDI MOBIL Sydney AU AUS Card xx5077 Value Date: 06/04/2024,423.37
09/04/2024,-4,QUINN HOTELS GROUP PTY WEST END AU AUS Card xx5077 Value Date: 06/04/2024,433.51
09/04/2024,-7.25,DidiChuxing DIDI MOBIL Sydney AU AUS Card xx5077 Value Date: 06/04/2024,437.51
09/04/2024,-54.99,APPLE.COM/BILL SYDNEY AU AUS Card xx5077 Value Date: 06/04/2024,444.76
09/04/2024,-95.89,UBER *EATS Sydney AU AUS Card xx5077 Value Date: 07/04/2024,499.75
09/04/2024,-87.9,UBER* EATS SYDNEY NS AUS Card xx5077 Value Date: 07/04/2024,595.64
09/04/2024,-19.07,DidiChuxing DIDI MOBIL Sydney AU AUS Card xx5077 Value Date: 07/04/2024,683.54
08/04/2024,200,Transfer from xx1056 CommBank app,702.61
08/04/2024,-63,ODIN PASS PTY LTD,502.61
08/04/2024,100,Transfer from xx0713 CommBank app,565.61
08/04/2024,-114,Transfer to xx0713 NetBank My purchase goal,465.61
07/04/2024,300,Transfer from xx1056 CommBank app,579.61
06/04/2024,-56.62,WOOLWORTHS 2614 BURANDA AU AUS Card xx5077 Value Date: 04/04/2024,279.61
05/04/2024,250,Transfer from xx1056 CommBank app,336.23
05/04/2024,-14.7,GUZMAN Y GOMEZ SURRY HILLS NS AUS Card xx5077 Value Date: 03/04/2024,86.23
05/04/2024,-9.15,IGA PULLENVALE PULLENVALE QL AUS Card xx5077 Value Date: 02/04/2024,100.93
05/04/2024,-13.9,BROOKLYN DONUT & COF INDOOROOPILLY QL AUS Card xx5077 Value Date: 02/04/2024,110.08
04/04/2024,70,Transfer from xx0713 CommBank app,123.98
04/04/2024,-17.11,UBER* TRIP SYDNEY NS AUS Card xx5077 Value Date: 02/04/2024,53.98
04/04/2024,-18.51,DidiChuxing DIDI MOBIL Sydney AU AUS Card xx5077 Value Date: 02/04/2024,71.09
04/04/2024,-53.8,KMART 1217 INDOOROOPILLY AU AUS Card xx5077 Value Date: 02/04/2024,89.6
04/04/2024,-27.37,STARBUCKS COFFEE D00 WOOLLOONGABBA QL AUS Card xx5077 Value Date: 01/04/2024,143.4
04/04/2024,-27.36,DidiChuxing DIDI MOBIL Sydney AU AUS Card xx5077 Value Date: 02/04/2024,170.77
04/04/2024,-20.45,UBER *TRIP Sydney AU AUS Card xx5077 Value Date: 02/04/2024,198.13
04/04/2024,-21.31,UBER *TRIP Sydney AU AUS Card xx5077 Value Date: 02/04/2024,218.58
04/04/2024,-10.98,UQ STORE PTY LTD ST LUCIA AUS Card xx5077 Value Date: 28/03/2024,239.89
03/04/2024,-30,Transfer To BENJAMIN YOUNG PayID Phone from CommBank App Gratitude,250.87
03/04/2024,30,Transfer from xx0713 CommBank app,280.87
03/04/2024,-4000,Transfer to xx1056 CommBank app,250.87
03/04/2024,4000,DEEPAK BALIYARSINGH REF 2024040300011776 EDUCATION AYUSH DAS,4250.87
03/04/2024,-100,Transfer to xx0713 CommBank app,250.87
03/04/2024,-150,Transfer To Rafael CommBank App Rent,350.87
03/04/2024,-750,Transfer to xx1056 CommBank app,500.87
03/04/2024,-9.1,BOOST JUICE UQ ST LUCIA QL AUS Card xx5077 Value Date: 28/03/2024,1250.87
03/04/2024,-38.93,NANDOS BURANDA SC Buranda AU AUS Card xx5077 Value Date: 29/03/2024,1259.97
03/04/2024,-6.39,UBER *TRIP Sydney AU AUS Card xx5077 Value Date: 29/03/2024,1298.9
03/04/2024,-14.46,UBER *TRIP Sydney AU AUS Card xx5077 Value Date: 29/03/2024,1305.29
03/04/2024,-36.8,Dominos Estore St Luci dominos.com.a AU AUS Card xx5077 Value Date: 30/03/2024,1319.75
03/04/2024,-6,SQ *OZI YEROS Brisbane City QL AUS Card xx5077 Value Date: 31/03/2024,1356.55
03/04/2024,-95.16,UBER *EATS Sydney AU AUS Card xx5077 Value Date: 31/03/2024,1362.55
03/04/2024,-8.09,UBER *TRIP Sydney AU AUS Card xx5077 Value Date: 31/03/2024,1457.71
03/04/2024,-10.24,UBER *TRIP Sydney AU AUS Card xx5077 Value Date: 31/03/2024,1465.8
03/04/2024,-8.09,UBER *TRIP Sydney AU AUS Card xx5077 Value Date: 30/03/2024,1476.04
03/04/2024,-14.16,UBER *TRIP Sydney AU AUS Card xx5077 Value Date: 30/03/2024,1484.13
03/04/2024,-2.99,APPLE.COM/BILL SYDNEY NS AUS Card xx5077 Value Date: 01/04/2024,1498.29
03/04/2024,-11.96,APPLE.COM/BILL SYDNEY NS AUS Card xx5077 Value Date: 01/04/2024,1501.28
03/04/2024,381.4,Salary UNI OF QLD 2263920 10712884,1513.24
03/04/2024,623.72,Salary UNI OF QLD 2263922 10712884,1131.84
02/04/2024,100,Transfer from xx1056 CommBank app,508.12
02/04/2024,50,Fast Transfer From DEEKSHA ANAND Fish stuff,408.12
01/04/2024,-0.01,Debit Excess Interest,358.12
31/03/2024,200,Transfer from xx1056 CommBank app,358.13
30/03/2024,30,Transfer from xx0713 CommBank app,158.13
30/03/2024,8.83,Fast Transfer From YVETTE TAN to PayID Phone CREDIT TO ACCOUNT,128.13
29/03/2024,100,Transfer from xx0713 CommBank app,119.3
29/03/2024,-4.27,KENKO SUSHI HOUSE ST LUCIA AU AUS Card xx5077 Value Date: 27/03/2024,19.3
29/03/2024,-12.52,KENKO SUSHI HOUSE ST LUCIA AU AUS Card xx5077 Value Date: 27/03/2024,23.57
29/03/2024,-0.15,IGA PULLENVALE PULLENVALE QL AUS Card xx5077 Value Date: 26/03/2024,36.09
29/03/2024,-15.33,IGA PULLENVALE PULLENVALE QL AUS Card xx5077 Value Date: 26/03/2024,36.24
29/03/2024,-67.98,H&M Brisbane AU0009 Brisbane City QL AUS Card xx5077 Value Date: 26/03/2024,51.57
29/03/2024,-134,L'OCCITANE AUSTRALIA BRISBANE QL AUS Card xx5077 Value Date: 26/03/2024,119.55
29/03/2024,-10,UBER *TRIP Sydney AU AUS Card xx5077 Value Date: 27/03/2024,253.55
29/03/2024,-30.27,UBER *TRIP Sydney AU AUS Card xx5077 Value Date: 27/03/2024,263.55
29/03/2024,-10.8,LAKESIDE ENTERPRISEQPS UNIVERSITY OF AUS Card xx5077 Value Date: 27/03/2024,293.82
28/03/2024,-28.49,DidiChuxing DIDI MOBIL Sydney AU AUS Card xx5077 Value Date: 26/03/2024,304.62
28/03/2024,-32.36,DidiChuxing DIDI MOBIL Sydney AU AUS Card xx5077 Value Date: 26/03/2024,333.11
28/03/2024,-60.4,The Cheesecake Shop Annerley QL AUS Card xx5077 Value Date: 26/03/2024,365.47
28/03/2024,-3.5,CantaloupeSystemsAustr Albion QL AUS Card xx5077 Value Date: 26/03/2024,425.87
28/03/2024,-17.21,UBER* EATS SYDNEY NS AUS Card xx5077 Value Date: 25/03/2024,429.37
28/03/2024,-48.46,UBER *TRIP Sydney AU AUS Card xx5077 Value Date: 26/03/2024,446.58
28/03/2024,-83.18,UBER* EATS SYDNEY NS AUS Card xx5077 Value Date: 26/03/2024,495.04
28/03/2024,-150,Transfer To Rafael CommBank App Rent,578.22
28/03/2024,150,Transfer from xx1056 CommBank app,728.22
27/03/2024,-114,Transfer to xx0713 NetBank My purchase goal,578.22
27/03/2024,-34.22,UBER *TRIP Sydney AU AUS Card xx5077 Value Date: 25/03/2024,692.22
27/03/2024,-18.51,UBER *TRIP Sydney AU AUS Card xx5077 Value Date: 25/03/2024,726.44
26/03/2024,600,Transfer from xx1056 CommBank app,744.95
26/03/2024,-4.5,CantaloupeSystemsAustr Albion QL AUS Card xx5077 Value Date: 22/03/2024,144.95
26/03/2024,-4.5,CantaloupeSystemsAustr Albion QL AUS Card xx5077 Value Date: 22/03/2024,149.45
26/03/2024,-3.7,CantaloupeSystemsAustr Albion QL AUS Card xx5077 Value Date: 22/03/2024,153.95
26/03/2024,-6.93,UBER *TRIP Sydney AU AUS Card xx5077 Value Date: 22/03/2024,157.65
26/03/2024,-20.5,UBER *TRIP Sydney AU AUS Card xx5077 Value Date: 22/03/2024,164.58
26/03/2024,-37.13,UBER* EATS SYDNEY NS AUS Card xx5077 Value Date: 24/03/2024,185.08
26/03/2024,-25.95,UBER *EATS Sydney AU AUS Card xx5077 Value Date: 23/03/2024,222.21
26/03/2024,-8.47,UBER *TRIP Sydney AU AUS Card xx5077 Value Date: 24/03/2024,248.16
26/03/2024,-13.51,UBER *TRIP Sydney AU AUS Card xx5077 Value Date: 23/03/2024,256.63
26/03/2024,-10.69,UBER *TRIP Sydney AU AUS Card xx5077 Value Date: 23/03/2024,270.14
25/03/2024,100,Transfer from xx1056 CommBank app Value Date: 26/03/2024,280.83
25/03/2024,-1.45,POST ST LUCIA LPO QL AU,180.83
25/03/2024,-9.8,Marketcart Herston AU,182.28
25/03/2024,-15.12,ORIENTAL CORNERORIENTAL CSt Lucia AU,192.08
24/03/2024,100,Transfer from xx1056 CommBank app,207.2
24/03/2024,-52.14,MCDONALDS QUEEN ST BRISBANE QLDAU,107.2
24/03/2024,-146.95,DYMOCKS BRISBANE PTY L BRISBANE AU,159.34
24/03/2024,100,Transfer from xx1056 CommBank app,306.29
23/03/2024,100,Transfer from xx0713 CommBank app,206.29
23/03/2024,-2.9,MILLIONLIFE AU PTY LTD Reedy CreeQLDAU,106.29
23/03/2024,-42,Dominos Estore New Far dominos.com.a AU AUS Card xx5077 Value Date: 21/03/2024,109.19
23/03/2024,-56,Dominos Estore Greensl dominos.com.a AU AUS Card xx5077 Value Date: 21/03/2024,151.19
23/03/2024,-4.5,CantaloupeSystemsAustr Albion QL AUS Card xx5077 Value Date: 21/03/2024,207.19
23/03/2024,42,Return Dominos Estore New Far dominos.com.a AU AUS Card xx5077 Value Date: 21/03/2024,211.69
22/03/2024,-15,Overdraw Fee For exceeding available funds on 21 Mar,169.69
22/03/2024,-10.05,IGA PULLENVALE PULLENVALE AU,184.69
22/03/2024,100,Transfer from xx0713 CommBank app,194.74
21/03/2024,50,Transfer from xx0713 CommBank app,94.74
21/03/2024,-5,TANGERPAY NSW AU AUS Card xx5077 Value Date: 19/03/2024,44.74
21/03/2024,-4,TANGERPAY Greenslopes AU AUS Card xx5077 Value Date: 19/03/2024,49.74
21/03/2024,-33.55,UBER* EATS SYDNEY NS AUS Card xx5077 Value Date: 18/03/2024,53.74
21/03/2024,-16.28,UBER *TRIP Sydney AU AUS Card xx5077 Value Date: 19/03/2024,87.29
20/03/2024,-100,Transfer to xx0713 CommBank app,103.57
20/03/2024,-150,Transfer to xx1056 CommBank app,203.57
20/03/2024,-150,Transfer To Rafael CommBank App Rent,353.57
20/03/2024,273.91,Salary ALH GROUP 236263,503.57
20/03/2024,-150,Transfer to xx0713 CommBank app,229.66
20/03/2024,-1000,Transfer to xx1056 CommBank app,379.66
20/03/2024,-12.8,LUV A COFFEE BURANDA BURANDA QLD AU,1379.66
20/03/2024,677.2,Salary UNI OF QLD 2263922 10712884,1392.46
20/03/2024,589.23,Salary UNI OF QLD 2263920 10712884,715.26
20/03/2024,-55.59,UBER *EATS Sydney AU AUS Card xx5077 Value Date: 17/03/2024,126.03
20/03/2024,-13.07,UBER *TRIP Sydney AU AUS Card xx5077 Value Date: 18/03/2024,181.62
20/03/2024,-26.23,UBER *TRIP Sydney AU AUS Card xx5077 Value Date: 18/03/2024,194.69
20/03/2024,-18.71,UBER *TRIP Sydney AU AUS Card xx5077 Value Date: 18/03/2024,220.92
19/03/2024,-25.59,WOOLWORTHS 2614 BURANDA QLD AU,239.63
19/03/2024,100,Transfer from xx1056 CommBank app,265.22
19/03/2024,-68.88,RIBS & BURGERS FORTITU FORTITUDE VAL QL AUS Card xx5077 Value Date: 15/03/2024,165.22
19/03/2024,-19.56,UBER *EATS Sydney AU AUS Card xx5077 Value Date: 14/03/2024,234.1
19/03/2024,-21.25,UBER *EATS Sydney AU AUS Card xx5077 Value Date: 15/03/2024,253.66
19/03/2024,-11.47,UBER *TRIP Sydney AU AUS Card xx5077 Value Date: 15/03/2024,274.91
19/03/2024,-13.48,PACIFIC CONCEPTS* ME&U THE ROCKS NS AUS Card xx5077 Value Date: 16/03/2024,286.38
19/03/2024,-19.95,IRE* 2APPLYWEB APPLICA MILTON QL AUS Card xx5077 Value Date: 17/03/2024,299.86
19/03/2024,-38.17,Temu.com INTERNET AUS Card xx5077 Value Date: 17/03/2024,319.81
19/03/2024,-48.06,UBER *EATS Sydney AU AUS Card xx5077 Value Date: 17/03/2024,357.98
19/03/2024,-8.35,UBER *TRIP Sydney AU AUS Card xx5077 Value Date: 17/03/2024,406.04
19/03/2024,-14.03,UBER *TRIP Sydney AU AUS Card xx5077 Value Date: 17/03/2024,414.39
19/03/2024,-25.97,UBER *TRIP Sydney AU AUS Card xx5077 Value Date: 16/03/2024,428.42
18/03/2024,100,Transfer from xx1056 CommBank app,454.39
18/03/2024,-17.55,IGA PULLENVALE PULLENVALE AU,354.39
