Date,Credit/Debit,Transaction Name,Balance
4/7/2024,-5,LAKESIDE ENTERPRISES UNIVERSITY OFAU Card xx4604,1234.46
4/7/2024,-17.71,LUCA CURRIE PTY LTD WOOLLOONGABBA QL AUS Card xx4604 Value Date: 02/07/2024,1239.46
3/7/2024,-22.95,DBS*Fitness Cartel Asp Aspley QL AUS Card xx4604 Value Date: 01/07/2024,1257.17
3/7/2024,-15,ANGELIKA FILM CENTRE WOOLLOONGABBA QL AUS Card xx4604 Value Date: 30/06/2024,1280.12
3/7/2024,-6.64,TCC Everton Hills Everton Hills QL AUS Card xx4604 Value Date: 30/06/2024,1295.12
3/7/2024,-1,LITTLE RED DUMPLING WOOLLOONGABBA QL AUS Card xx4604 Value Date: 30/06/2024,1301.76
3/7/2024,-4,LITTLE RED DUMPLING WOOLLOONGABBA QL AUS Card xx4604 Value Date: 30/06/2024,1302.76
3/7/2024,-6.2,FOSTER & BLACK P/L CHERMSIDE QL AUS Card xx4604 Value Date: 29/06/2024,1306.76
3/7/2024,-45,THE BARBER ROOM BRISBANE AUS Card xx4604 Value Date: 01/07/2024,1312.96
3/7/2024,-3.15,DRAKE SUPERMARKETS M MCDOWALL AUS Card xx4604 Value Date: 30/06/2024,1357.96
2/7/2024,-10,Sportsbet,1361.11
2/7/2024,-4.27,SQ *HEY MR.DUTTON PARK Dutton Park QL AUS Card xx4604 Value Date: 28/06/2024,1371.11
2/7/2024,-2.9,WOOLWORTHS 2678 ASPLEY AU AUS Card xx4604 Value Date: 28/06/2024,1375.38
2/7/2024,-30,KMART 1218KMART 1218 ASPLEY AU AUS Card xx4604 Value Date: 28/06/2024,1378.28
2/7/2024,-17.69,ZLR*sunshine kebab Aa Aspley AU AUS Card xx4604 Value Date: 28/06/2024,1408.28
2/7/2024,-5.8,COLES 4547COLES 4547 CHERMSIDE AU AUS Card xx4604 Value Date: 29/06/2024,1425.97
2/7/2024,-12.14,SQ *MELT BROTHERS CHER Chermside QL AUS Card xx4604 Value Date: 29/06/2024,1431.77
2/7/2024,-6.7,MEKONG CHERMSIDE Chermside QL AUS Card xx4604 Value Date: 29/06/2024,1443.91
2/7/2024,-22.9,CHERMSIDE FISH MARKET CHERMSIDE QL AUS Card xx4604 Value Date: 29/06/2024,1450.61
2/7/2024,-11.61,CHERMSIDE BUTCHER CHERMSIDE QL AUS Card xx4604 Value Date: 29/06/2024,1473.51
2/7/2024,-8.25,WOOLWORTHS 2865 WOOLLOONGABBA AU AUS Card xx4604 Value Date: 30/06/2024,1485.12
2/7/2024,-27.13,LITTLE RED DUMPLING GA ROCHEDALE SOU QL AUS Card xx4604 Value Date: 30/06/2024,1493.37
2/7/2024,-5.55,SQ *BRISBEAN COFFEE Alderley AU,1520.5
1/7/2024,-15.86,SQ *HEY MR.DUTTON PARK Dutton Park AU,1526.05
30/6/2024,-10,Le Boulangerie Amour WoolloongabbaAU,1541.91
29/6/2024,-97.49,AMPOL CHERMSIDE 11885F CHERMSIDE AUS Card xx4604 Value Date: 27/06/2024,1551.91
28/6/2024,-4.6,ALH VENUES 8098 MITCHELTON AU AUS Card xx4604 Value Date: 26/06/2024,1649.4
28/6/2024,-47.13,COLES 4547COLES 4547 CHERMSIDE AU AUS Card xx4604 Value Date: 26/06/2024,1654
28/6/2024,-4.6,ALH VENUES 8098 MITCHELTON AU AUS Card xx4604 Value Date: 26/06/2024,1701.13
28/6/2024,-20.48,CellOPark Australia Matraville NS AUS Card xx4604 Value Date: 26/06/2024,1705.73
27/6/2024,-6.71,Direct Debit 617704 PAYPAL AUSTRALIA 1035282845122,1726.21
27/6/2024,726,Salary Q GROUP 25062024VAND,1732.92
27/6/2024,-101.19,WWW.GFPEVENTS.COM.AU,1006.92
27/6/2024,-1.69,Transfer to other Bank CommBank app heres a cigarette,1108.11
27/6/2024,-6.5,MUFFIN BREAK CHERMS CHERMSIDE AU,1109.8
27/6/2024,-5.59,SQ *HEY MR.DUTTON PARK Dutton Park QL AUS Card xx4604 Value Date: 25/06/2024,1116.3
27/6/2024,-14.3,SUSHI HUB ALBERT ST BRISBANE CITY QL AUS Card xx4604 Value Date: 24/06/2024,1121.89
27/6/2024,-14.9,VIETS ROLL STREET FOOD WOOLLOONGABBA AUS Card xx4604 Value Date: 25/06/2024,1136.19
26/6/2024,-1.15,MCDONALDS BROOKSIDE MITCHELTON QLDAU,1151.09
26/6/2024,-27.93,Transfer to other Bank CommBank app food,1152.24
26/6/2024,-12.3,COLES 4430 MITCHELTON AU,1180.17
26/6/2024,-5.66,SQ *CAFFE CHERRY BEANS Chermside AU,1192.47
26/6/2024,-22.95,DBS*Fitness Cartel Asp Aspley QL AUS Card xx4604 Value Date: 24/06/2024,1198.13
26/6/2024,-12.25,YO CHI ALBERT ST BRISBANE ADEL QL AUS Card xx4604 Value Date: 21/06/2024,1221.08
26/6/2024,-5.55,SQ *BRISBEAN COFFEE Alderley QL AUS Card xx4604 Value Date: 25/06/2024,1233.33
26/6/2024,-10,TRANSLINK SMARTTICKET QLD AUS Card xx4604 Value Date: 25/06/2024,1238.88
25/6/2024,-34.5,chicken of rock Fortitude ValAU,1248.88
25/6/2024,-5.59,SQ *HEY MR.DUTTON PARK Dutton Park AU,1283.38
25/6/2024,-32,JB HI FI CHERMSIDE CHERMSIDE QL AUS Card xx4604 Value Date: 20/06/2024,1288.97
25/6/2024,-30,TRANSLINK BRISBANE AUS Card xx4604 Value Date: 24/06/2024,1320.97
24/6/2024,-17.02,Direct Debit 617704 PAYPAL AUSTRALIA 1035191940219,1350.97
24/6/2024,-12.75,COLES 4334 BRISBANE AU,1367.99
24/6/2024,-11,LushAustraliaPOS Brisbane AU,1380.74
24/6/2024,-23.38,SQ *HEY MR.DUTTON PARK Dutton Park AU,1391.74
23/6/2024,-5,ZARRAFFAS COFFEE GROVELY KEPERRA QLD AU Card xx4604,1415.12
23/6/2024,-88,Transfer To Christian Carbone CommBank App Happy birthday mate! -- ...,1420.12
22/6/2024,-5.6,MUFFIN BREAK CHERMS CHERMSIDE AU,1508.12
22/6/2024,-5,COLES 4547COLES 4547 CHERMSIDE AU AUS Card xx4604 Value Date: 20/06/2024,1513.72
22/6/2024,-23.5,SMP*Cafe 63 Chermside Chermside AU AUS Card xx4604 Value Date: 20/06/2024,1518.72
21/6/2024,-10,KARAOKE CITY BRISBANE AU Card xx4604,1542.22
21/6/2024,-15.5,VIETS ROLL STREET FOOD WOOLLOONGABBAAU,1552.22
21/6/2024,-5.55,SQ *BRISBEAN COFFEE Alderley AU,1567.72
21/6/2024,-21.32,RODE MEATS STAFFORD HEIG QL AUS Card xx4604 Value Date: 19/06/2024,1573.27
21/6/2024,-25,MED*ALDIMobile CHATSWOOD AU AUS Card xx4604 Value Date: 19/06/2024,1594.59
21/6/2024,-18,KRUSTY KRAB SEAFOODS MCDOWALL QL AUS Card xx4604 Value Date: 18/06/2024,1619.59
21/6/2024,-6.7,ZARRAFFAS COFFEE GROV KEPERRA AUS Card xx4604 Value Date: 19/06/2024,1637.59
20/6/2024,726,Salary Q GROUP 18062024VAND,1644.29
20/6/2024,-23.8,CHERMSIDE FISH MARKET CHERMSIDE QLD AU,918.29
19/6/2024,-9.16,SQ *SOUFFLE JAPANCAKES Chermside QL AUS Card xx4604 Value Date: 17/06/2024,942.09
19/6/2024,-22.95,DBS*Fitness Cartel Asp Aspley QL AUS Card xx4604 Value Date: 17/06/2024,951.25
19/6/2024,-113.93,7-ELEVEN 4098 ASPLEY QL AUS Card xx4604 Value Date: 16/06/2024,974.2
19/6/2024,-7.98,GZ BLUE PTY LTD BRISBANE CITY AUS Card xx4604 Value Date: 14/06/2024,1088.13
18/6/2024,-5.5,CHEZ NOUS CAFE BRISBANE QL AUS Card xx4604 Value Date: 14/06/2024,1096.11
18/6/2024,-5.1,8TH MCDOWALL CAFE PTY MCDOWALL AU AUS Card xx4604 Value Date: 16/06/2024,1101.61
18/6/2024,-5.55,SQ *BRISBEAN COFFEE Alderley AU,1106.71
17/6/2024,-4.98,SQ *HEY MR.DUTTON PARK Dutton Park AU,1112.26
15/6/2024,-38.55,COLES 4547 CHERMSIDE AU AUS Card xx4604 Value Date: 13/06/2024,1117.24
14/6/2024,-7,99 Bikes Brisbane CBD Brisbane AU,1155.79
14/6/2024,-16.15,MEKONG 2 CITY PTY LTD Brisbane AU,1162.79
14/6/2024,-24.88,OFFICEWORKS 0415 ASPLEY AU AUS Card xx4604 Value Date: 12/06/2024,1178.94
14/6/2024,-11.99,GOOGLE*PLAY BOOKS G.CO/HELPPAY# AU AUS Card xx4604 Value Date: 12/06/2024,1203.82
14/6/2024,-5.3,STARBUCKS COFFEE D03 FORTITUDE VAL QL AUS Card xx4604 Value Date: 12/06/2024,1215.81
14/6/2024,-18.5,GOLD LAYERS KANGAROO POIN QL AUS Card xx4604 Value Date: 12/06/2024,1221.11
14/6/2024,-5.56,COFFEE AT THE KOMBI SOUTH BRISBAN AUS Card xx4604 Value Date: 12/06/2024,1239.61
13/6/2024,507,Salary Q GROUP 11062024VAND,1245.17
13/6/2024,-5.6,MUFFIN BREAK CHERMS CHERMSIDE AU,738.17
13/6/2024,-14.97,TEMU.COM PARRAMATTA NS AUS Card xx4604 Value Date: 11/06/2024,743.77
13/6/2024,-30,TRANSLINK BRISBANE AUS Card xx4604 Value Date: 12/06/2024,758.74
12/6/2024,-14,8TH MCDOWALL CAFE PTY MCDOWALL AU AUS Card xx4604 Value Date: 10/06/2024,788.74
12/6/2024,-22.95,DBS*Fitness Cartel Asp Aspley QL AUS Card xx4604 Value Date: 10/06/2024,802.74
12/6/2024,-7.86,YO GET IT QLD CHERMSIDE QL AUS Card xx4604 Value Date: 09/06/2024,825.69
11/6/2024,-4.5,Krispy Kreme Albert St 131 Queen StrAU,833.55
11/6/2024,-21,ZAIHOU PTY LTD BRISBANE CITYAU Card xx4604,838.05
11/6/2024,-12,CASSIS AUSTRALIA PTY L WOOLLOONGABBA AU AUS Card xx4604 Value Date: 07/06/2024,859.05
11/6/2024,-17.5,KRUSTY KRAB SEAFOODS MCDOWALL QL AUS Card xx4604 Value Date: 06/06/2024,871.05
11/6/2024,-39.75,COLES EXPRESS 1860 WINDSOR AU AUS Card xx4604 Value Date: 09/06/2024,888.55
11/6/2024,-15.6,CantaloupeSystemsAustr Albion QL AUS Card xx4604 Value Date: 09/06/2024,928.3
11/6/2024,-4,CantaloupeSystemsAustr Albion QL AUS Card xx4604 Value Date: 09/06/2024,943.9
11/6/2024,-5.55,SQ *BRISBEAN COFFEE Alderley AU,947.9
10/6/2024,-23.9,Nandos_AU_Pinpads Newmarket AU,953.45
10/6/2024,-5.94,UQU Bakery St Lucia AU,977.35
10/6/2024,-5.08,UQU Bakery St Lucia AU,983.29
10/6/2024,-14.14,DRAKE SUPERMARKETS M MCDOWALL AU,988.37
9/6/2024,-24.2,GYG WF Chermside Chermside AU,1002.51
9/6/2024,-6.65,Chatime UQ St Lucia St Lucia AU,1026.71
9/6/2024,-18.5,Espresso Garage South BrisbanAU,1033.36
9/6/2024,-5.56,COFFEE AT THE KOMBI SOUTH BRISBAN QLD AU,1051.86
8/6/2024,-26.24,SQ *SAINT LUCY CAFFE St lucia AU,1057.42
8/6/2024,-5.3,BAR MERLO UQ BRISBANE AU,1083.66
8/6/2024,-3.7,CantaloupeSystemsAustr Albion QL AUS Card xx4604 Value Date: 06/06/2024,1088.96
7/6/2024,-90.99,URBAN THAI MASSAGE & SPA BRISBANE QLD AU,1092.66
7/6/2024,-5.59,SQ *HEY MR.DUTTON PARK Dutton Park AU,1183.65
7/6/2024,-6.56,SQ *BRISBEAN COFFEE Alderley AU,1189.24
7/6/2024,-4.4,ALH VENUES 8098 MITCHELTON AU AUS Card xx4604 Value Date: 05/06/2024,1195.8
7/6/2024,-4.2,ALH VENUES 8098 MITCHELTON AU AUS Card xx4604 Value Date: 05/06/2024,1200.2
7/6/2024,-4.58,KENKO SUSHI HOUSE ST LUCIA AU AUS Card xx4604 Value Date: 05/06/2024,1204.4
7/6/2024,-11.2,BAR MERLO UQ BRISBANE QL AUS Card xx4604 Value Date: 05/06/2024,1208.98
7/6/2024,-13,Guzman y Gomez St Lucia QL AUS Card xx4604 Value Date: 05/06/2024,1220.18
7/6/2024,-36.62,WWW.ALHGROUP.COM* ME&U SYDNEY NS AUS Card xx4604 Value Date: 05/06/2024,1233.18
6/6/2024,-19.17,DRAKE SUPERMARKETS M MCDOWALL AU,1269.8
6/6/2024,-1,KRUSTY KRAB SEAFOODS MCDOWALL QLD AU,1288.97
6/6/2024,-5.1,SQ *SMOKIN JOES ESPRES Everton Park AU,1289.97
6/6/2024,-14.6,TCC Everton Hills Everton Hills QL AUS Card xx4604 Value Date: 03/06/2024,1295.07
6/6/2024,-4.74,OFFICEWORKS 0415 ASPLEY AU AUS Card xx4604 Value Date: 04/06/2024,1309.67
5/6/2024,-17,UQ SPORT LTD ST LUCIA AU,1314.41
5/6/2024,-22.95,DBS*Fitness Cartel Asp Aspley QL AUS Card xx4604 Value Date: 03/06/2024,1331.41
5/6/2024,-6,ZARRAFFAS COFFEE GROV KEPERRA AUS Card xx4604 Value Date: 02/06/2024,1354.36
4/6/2024,-6.45,MCDONALDS DT 0306 KEPERRA QLDAU,1360.36
4/6/2024,-6,ZARRAFFAS COFFEE GROVELY KEPERRA QLD AU Card xx4604,1366.81
4/6/2024,-6.64,TCC Everton Hills Everton Hills QL AUS Card xx4604 Value Date: 30/05/2024,1372.81
4/6/2024,-53.2,7 ELEVEN 4229 EVERTON HILLS QL AUS Card xx4604 Value Date: 01/06/2024,1379.45
4/6/2024,-14.6,TCC Everton Hills Everton Hills QL AUS Card xx4604 Value Date: 01/06/2024,1432.65
1/6/2024,-38.88,Transfer to xx6073 CommBank app,1447.25
1/6/2024,38.88,Transfer from xx3679 CommBank app,1486.13
31/5/2024,-21580,Transfer to xx6073 NetBank,1447.25
31/5/2024,21579.36,Transfer from xx3679 NetBank,23027.25
31/5/2024,-6,ZARRAFFAS COFFEE GROVELY KEPERRA QLD AU Card xx4604,1447.89
31/5/2024,-5,Marketcart Herston AU AUS Card xx4604 Value Date: 29/05/2024,1453.89
31/5/2024,-14.13,YUMMO SUSHI SOUTH BRISBAN QL AUS Card xx4604 Value Date: 29/05/2024,1458.89
30/5/2024,-1500,Transfer to xx3679 NetBank,1473.02
30/5/2024,-19.95,UPDOC.COM.AU -KNPAGPWR,2973.02
30/5/2024,-11.9,Guzman y Gomez ACD Albany Creek AU,2992.97
30/5/2024,-12.9,Guzman y Gomez St Lucia QL AUS Card xx4604 Value Date: 29/05/2024,3004.87
29/5/2024,726,Salary Q GROUP 28052024VAND,3017.77
29/5/2024,-105.99,SUPER CHEAP AUTO EVE EVERTON PARK QL AUS Card xx4604 Value Date: 27/05/2024,2291.77
29/5/2024,-22.95,DBS*Fitness Cartel Asp Aspley QL AUS Card xx4604 Value Date: 27/05/2024,2397.76
29/5/2024,-27.08,CellOPark Australia Matraville NS AUS Card xx4604 Value Date: 27/05/2024,2420.71
28/5/2024,-21,ZAIHOU PTY LTD BRISBANE CITYAU Card xx4604,2447.79
28/5/2024,-13.01,SQ *HEY MR.DUTTON PARK Dutton Park AU,2468.79
28/5/2024,-8.9,CHERMSIDE BUTCHER CHERMSIDE QL AUS Card xx4604 Value Date: 25/05/2024,2481.8
28/5/2024,-5.55,SQ *BRISBEAN COFFEE Alderley AU,2490.7
27/5/2024,-14.13,SQ *HEY MR.DUTTON PARK Dutton Park AU,2496.25
27/5/2024,-4.98,SQ *HEY MR.DUTTON PARK Dutton Park AU,2510.38
27/5/2024,-13.62,SQ *BRISBEAN COFFEE Alderley AU,2515.36
26/5/2024,-4.56,SQ *SAINT LUCY CAFFE St lucia AU,2528.98
26/5/2024,-2.65,DAN DAN DRINKS PTY LTD Middle ParQLDAU,2533.54
26/5/2024,-1.25,IGA ST LUCIA ST LUCIA AU Card xx4604,2536.19
26/5/2024,-26.7,YINGHONG ZHANG ST LUCIA QLD AU Card xx4604,2537.44
25/5/2024,-3.6,COLES 4547 CHERMSIDE AU,2564.14
25/5/2024,-5,Cafe 641.5 Chermside Chermside AU,2567.74
25/5/2024,-6.5,Cafe 641.5 Chermside Chermside AU,2572.74
25/5/2024,-5.5,SQ *COFFEE BARRE Aspley AU,2579.24
25/5/2024,-5.4,BOOKMARK CAFE ST LUCIA QL AUS Card xx4604 Value Date: 23/05/2024,2584.74
24/5/2024,-2.5,Gecko Vending - Wararb Wamuran QLDAU,2590.14
24/5/2024,-18.09,SQ *HEY MR.DUTTON PARK Dutton Park AU,2592.64
23/5/2024,-19.95,UPDOC.COM.AU -KNPAGPWR,2610.73
23/5/2024,-13.62,SQ *BRISBEAN COFFEE Alderley AU,2630.68
22/5/2024,726,Salary Q GROUP 21052024VAND,2644.3
22/5/2024,-14.17,UQU Main Refectory St Lucia AU,1918.3
22/5/2024,-9.2,LAKESIDE ENTERPRISES UNIVERSITY OFAU Card xx4604,1932.47
22/5/2024,-21,LAKESIDE ENTERPRISES UNIVERSITY OFAU Card xx4604,1941.67
22/5/2024,-19,CASSIS AUSTRALIA PTY L WOOLLOONGABBA AU AUS Card xx4604 Value Date: 20/05/2024,1962.67
22/5/2024,-22.95,DBS*Fitness Cartel Asp Aspley QL AUS Card xx4604 Value Date: 20/05/2024,1981.67
22/5/2024,-5.4,7-ELEVEN 4098 ASPLEY QL AUS Card xx4604 Value Date: 19/05/2024,2004.62
22/5/2024,-100.11,CALTEX EVERTON PARK EVERTON PARK AUS Card xx4604 Value Date: 18/05/2024,2010.02
22/5/2024,-5.99,THE STANDARD MARKET C SOUTHPORT AUS Card xx4604 Value Date: 19/05/2024,2110.13
22/5/2024,-30,TRANSLINK BRISBANE AUS Card xx4604 Value Date: 21/05/2024,2116.12
21/5/2024,-4.2,DRAKE SUPERMARKETS M MCDOWALL AU,2146.12
21/5/2024,-1.1,MCDONALDS CENTRAL BRISBANE CITYQLDAU,2150.32
21/5/2024,-1.1,MCDONALDS CENTRAL BRISBANE CITYQLDAU,2151.42
21/5/2024,-15.8,CHAPTER 3 BRISBANE CITY AU,2152.52
21/5/2024,-2.5,Gecko Vending - Wararb Wamuran QLDAU,2168.32
21/5/2024,-5.59,SQ *HEY MR.DUTTON PARK Dutton Park AU,2170.82
21/5/2024,-4.45,Microsoft*Store Sydney AU AUS Card xx4604 Value Date: 18/05/2024,2176.41
21/5/2024,-62.99,SUPER CHEAP AUTO CHERMSIDE QL AUS Card xx4604 Value Date: 18/05/2024,2180.86
21/5/2024,-21.69,SUPER CHEAP AUTO KEPERRA QL AUS Card xx4604 Value Date: 18/05/2024,2243.85
21/5/2024,-25,MED*ALDIMobile CHATSWOOD AU AUS Card xx4604 Value Date: 19/05/2024,2265.54
21/5/2024,-13.62,SQ *BRISBEAN COFFEE Alderley AU,2290.54
20/5/2024,-169,99 Bikes Everton Park Everton Park AU,2304.16
20/5/2024,-5.08,SQ *HEY MR.DUTTON PARK Dutton Park AU,2473.16
20/5/2024,-2.5,Gecko Vending - Wararb Wamuran QLDAU,2478.24
20/5/2024,-2.54,SQ *HEY MR.DUTTON PARK Dutton Park AU,2480.74
20/5/2024,-13.62,SQ *BRISBEAN COFFEE Alderley AU,2483.28
18/5/2024,-68.9,BLURB HOLDINGS PTY L SURFERS PARA AU,2496.9
18/5/2024,-0.45,BP LOGAN MOTOWAY695 LARAPINTA AU,2565.8
18/5/2024,-6,ZARRAFFAS COFFEE GROVELY KEPERRA QLD AU Card xx4604,2566.25
18/5/2024,-5.3,BAR MERLO UQ BRISBANE QL AUS Card xx4604 Value Date: 16/05/2024,2572.25
18/5/2024,-8.6,SUSHI HUB ALBERT ST BRISBANE CITY QL AUS Card xx4604 Value Date: 15/05/2024,2577.55
17/5/2024,-6.9,Krispy Kreme Albert St 131 Queen StrAU,2586.15
17/5/2024,-23.5,ZAIHOU PTY LTD BRISBANE CITYAU Card xx4604,2593.05
17/5/2024,-8.07,SQ *BRISBEAN COFFEE Alderley AU,2616.55
17/5/2024,-6.56,SQ *BRISBEAN COFFEE Alderley AU,2624.62
17/5/2024,-4,CantaloupeSystemsAustr Albion QL AUS Card xx4604 Value Date: 15/05/2024,2631.18
17/5/2024,-12.1,UQU Main Refectory St Lucia QL AUS Card xx4604 Value Date: 16/05/2024,2635.18
17/5/2024,-5.35,THE UNIVERSITY OF QU ST LUCIA AUS Card xx4604 Value Date: 16/05/2024,2647.28
16/5/2024,-9.6,UQU Main Refectory St Lucia AU,2652.63
16/5/2024,-8.48,UQU Bakery St Lucia AU,2662.23
16/5/2024,-7.93,SQ *HEY MR.DUTTON PARK Dutton Park QL AUS Card xx4604 Value Date: 14/05/2024,2670.71
15/5/2024,726,Salary Q GROUP 14052024VAND,2678.64
15/5/2024,-4.5,Krispy Kreme Albert St 131 Queen StrAU,1952.64
15/5/2024,-7.54,UQU Main Refectory St Lucia AU,1957.14
15/5/2024,-5.55,SQ *BRISBEAN COFFEE Alderley AU,1964.68
15/5/2024,-5.3,BAR MERLO UQ BRISBANE QL AUS Card xx4604 Value Date: 11/05/2024,1970.23
15/5/2024,-22.95,DBS*Fitness Cartel Asp Aspley QL AUS Card xx4604 Value Date: 13/05/2024,1975.53
15/5/2024,-8.8,SUSHI HUB ALBERT ST BRISBANE CITY QL AUS Card xx4604 Value Date: 12/05/2024,1998.48
15/5/2024,1738.08,Return UNITED1623873508600 CONTINENTAL AU AUS Card xx4604 Value Date: 11/05/2024,2007.28
14/5/2024,-13,CHEZ NOUS CAFE BRISBANE QL AUS Card xx4604 Value Date: 10/05/2024,269.2
14/5/2024,-8.17,YO CHI ALBERT ST BRISBANE ADEL QL AUS Card xx4604 Value Date: 10/05/2024,282.2
14/5/2024,-1.25,WOOLWORTHS 2583 STAFFORD AU AUS Card xx4604 Value Date: 11/05/2024,290.37
14/5/2024,-6.1,THE BAGEL BOYS PTY LTD ST LUCIA AU AUS Card xx4604 Value Date: 11/05/2024,291.62
14/5/2024,-4,CantaloupeSystemsAustr Albion QL AUS Card xx4604 Value Date: 11/05/2024,297.72
14/5/2024,-1738.08,UNITED1623873508600 CONTINENTAL AU AUS Card xx4604 Value Date: 10/05/2024,301.72
13/5/2024,-11.1,DRAKE SUPERMARKETS M MCDOWALL AU,2039.8
13/5/2024,-8.13,SQ *HEY MR.DUTTON PARK Dutton Park AU,2050.9
12/5/2024,-79,Lululemon Brisbane AU,2059.03
12/5/2024,-52.9,Nutrition Warehouse Brisbane AU,2138.03
12/5/2024,-7.5,STARBUCKS COFFEE D00 BRISBANE AU,2190.93
12/5/2024,-11.05,STARBUCKS COFFEE D02 BRISBANE AU,2198.43
11/5/2024,-24,KMART 1275 STAFFORD AU,2209.48
10/5/2024,-17.98,Thai Street Kitchen Brisbane AU,2233.48
10/5/2024,-29.9,FEATHER.COM.AU KINCUMBER NS AUS Card xx4604 Value Date: 08/05/2024,2251.46
10/5/2024,-16.67,THE BAGEL BOYS PTY LTD ST LUCIA AU AUS Card xx4604 Value Date: 08/05/2024,2281.36
10/5/2024,-4,CantaloupeSystemsAustr Albion QL AUS Card xx4604 Value Date: 08/05/2024,2298.03
10/5/2024,-14.3,SUSHI HUB ALBERT ST BRISBANE CITY QL AUS Card xx4604 Value Date: 07/05/2024,2302.03
10/5/2024,-30,TRANSLINK BRISBANE AUS Card xx4604 Value Date: 08/05/2024,2316.33
9/5/2024,30,Fast Transfer From LOURDES VAN DER NEUT Food,2346.33
9/5/2024,-6,ZARRAFFAS COFFEE GROVELY KEPERRA QLD AU Card xx4604,2316.33
9/5/2024,-29.4,KFC ASPLEY ASPLEY QL AUS Card xx4604 Value Date: 06/05/2024,2322.33
9/5/2024,-11.98,MR TOYS TOYWORLD ASPLEY QL AUS Card xx4604 Value Date: 06/05/2024,2351.73
8/5/2024,-1.1,MCDONALDS QUEEN ST BRISBANE QLDAU,2363.71
8/5/2024,-24.1,ZAIHOU PTY LTD BRISBANE CITYAU Card xx4604,2364.81
8/5/2024,521.38,Salary Q GROUP 07052024VAND,2388.91
8/5/2024,-17,UQ SPORT LTD ST LUCIA AU,1867.53
8/5/2024,-6.08,UQ STORE PTY LTD St Lucia AU,1884.53
8/5/2024,-22.95,DBS*Fitness Cartel Asp Aspley QL AUS Card xx4604 Value Date: 06/05/2024,1890.61
8/5/2024,-61,Bulk Nutrients 61362664725 TA AUS Card xx4604 Value Date: 05/05/2024,1913.56
7/5/2024,-17.18,SQ *HEY MR.DUTTON PARK Dutton Park AU,1974.56
7/5/2024,-46.77,WWW.ALHGROUP.COM* ME&U SYDNEY NS AUS Card xx4604 Value Date: 03/05/2024,1991.74
7/5/2024,-33.5,SMP*Cafe 63 Chermside Chermside AU AUS Card xx4604 Value Date: 05/05/2024,2038.51
7/5/2024,-17.04,HAROL'S ESPRESSO PTY Brisbane CityAU,2072.01
5/5/2024,-6,ZARRAFFAS COFFEE GROVELY KEPERRA QLD AU Card xx4604,2089.05
4/5/2024,-16.67,THE BAGEL BOYS PTY LTD ST LUCIA AU AUS Card xx4604 Value Date: 02/05/2024,2095.05
4/5/2024,-4.7,BAR MERLO UQ BRISBANE QL AUS Card xx4604 Value Date: 02/05/2024,2111.72
4/5/2024,-5.64,TCC Everton Hills Everton Hills QL AUS Card xx4604 Value Date: 01/05/2024,2116.42
4/5/2024,-50.17,COLES EXPRESS 1775 ASPLEY AU AUS Card xx4604 Value Date: 02/05/2024,2122.06
3/5/2024,-17.9,VIETS ROLL STREET FOOD WOOLLOONGABBAAU,2172.23
3/5/2024,-14.03,SQ *HEY MR.DUTTON PARK Dutton Park AU,2190.13
3/5/2024,-3.75,DRAKE SUPERMARKETS M MCDOWALL AUS Card xx4604 Value Date: 30/04/2024,2204.16
2/5/2024,278,Salary Q GROUP 30042024VAND,2207.91
2/5/2024,-11.1,Boost Albert Street Brisbane AU,1929.91
2/5/2024,-13.4,CHEZ NOUS CAFE BRISBANE QL AUS Card xx4604 Value Date: 30/04/2024,1941.01
2/5/2024,-10,SUSHI TRAIN ASPLEY ASPLEY QL AUS Card xx4604 Value Date: 29/04/2024,1954.41
1/5/2024,507,Salary Q GROUP 30042024VAND,1964.41
1/5/2024,-5.4,7-ELEVEN 4166 ASPLEY QL AUS Card xx4604 Value Date: 29/04/2024,1457.41
1/5/2024,-22.95,DBS*Fitness Cartel Asp Aspley QL AUS Card xx4604 Value Date: 29/04/2024,1462.81
1/5/2024,-5,FITNESS CARTEL ASPLE ASPLEY QL AUS Card xx4604 Value Date: 27/04/2024,1485.76
1/5/2024,-4.79,SMITHAM BREWERY PTY MURARRIE AUS Card xx4604 Value Date: 27/04/2024,1490.76
1/5/2024,-48.64,SMITHAM BREWERY PTY MURARRIE AUS Card xx4604 Value Date: 27/04/2024,1495.55
1/5/2024,-6.2,FOSTER & BLACK P/L CHERMSIDE QL AUS Card xx4604 Value Date: 28/04/2024,1544.19
30/4/2024,-5.79,SQ *BREADTOP MYER CENT Brisbane City AU,1550.39
30/4/2024,-16.25,MEKONG 2 CITY PTY LTD Brisbane AU,1556.18
30/4/2024,-27,Thalassina West End QL AUS Card xx4604 Value Date: 26/04/2024,1572.43
30/4/2024,-3.5,CantaloupeSystemsAustr Albion QL AUS Card xx4604 Value Date: 26/04/2024,1599.43
30/4/2024,-5.3,BAR MERLO UQ BRISBANE QL AUS Card xx4604 Value Date: 26/04/2024,1602.93
30/4/2024,-15.6,CantaloupeSystemsAustr Albion QL AUS Card xx4604 Value Date: 25/04/2024,1608.23
30/4/2024,-5.7,CantaloupeSystemsAustr Albion QL AUS Card xx4604 Value Date: 25/04/2024,1623.83
30/4/2024,-34.35,MCDONALDS DT 1040 MILTON AUS Card xx4604 Value Date: 25/04/2024,1629.53
30/4/2024,-21.9,YINGHONG ZHANG ST LUCIA AUS Card xx4604 Value Date: 25/04/2024,1663.88
30/4/2024,-10.5,LAKESIDE ENTERPRISEQPS UNIVERSITY OF AUS Card xx4604 Value Date: 26/04/2024,1685.78
30/4/2024,-4.5,HG RETAIL PTY LTD ST LUCIA AUS Card xx4604 Value Date: 25/04/2024,1696.28
30/4/2024,-25,KMART 1218 ASPLEY AU AUS Card xx4604 Value Date: 27/04/2024,1700.78
30/4/2024,-9.9,7-ELEVEN 4100 FORTITUDE VAL QL AUS Card xx4604 Value Date: 27/04/2024,1725.78
30/4/2024,-27.65,SQ *HEY MR.DUTTON PARK Dutton Park QL AUS Card xx4604 Value Date: 29/04/2024,1735.68
30/4/2024,-8,WESTFIELD CHERMSIDE CHERMSIDE AUS Card xx4604 Value Date: 28/04/2024,1763.33
29/4/2024,-19.31,SQ *HEY MR.DUTTON PARK Dutton Park AU,1771.33
28/4/2024,-8.25,EVENT CINEMAS CHERMS CHERMSIDE AU Card xx4604,1790.64
28/4/2024,-28,EVENT CINEMAS CHERMS CHERMSIDE AU Card xx4604,1798.89
28/4/2024,-22.2,ZAIHOU PTY LTD CHERMSIDE AU Card xx4604,1826.89
27/4/2024,-27.5,chicken of rock Fortitude ValAU,1849.09
27/4/2024,-2.85,DAN DAN DRINKS PTY LTD Middle Park AU AUS Card xx4604 Value Date: 25/04/2024,1876.59
27/4/2024,-53.07,COLES EXPRESS 2149 KEDRON AU AUS Card xx4604 Value Date: 25/04/2024,1879.44
26/4/2024,-1.1,MCDONALDS DT 0974 NEWMARKET QLDAU,1932.51
26/4/2024,-10.8,LAKESIDE ENTERPRISES UNIVERSITY OFAU Card xx4604,1933.61
25/4/2024,-30,TRANSLINK BRISBANE AUS Card xx4604 Value Date: 23/04/2024,1944.41
24/4/2024,752.75,Salary Q GROUP 23042024VAND,1974.41
24/4/2024,-4.5,Krispy Kreme Albert St 131 Queen StrAU,1221.66
24/4/2024,-15.96,Thai Street Kitchen Brisbane AU,1226.16
24/4/2024,-18,VIETS ROLL STREET FOOD WOOLLOONGABBAAU,1242.12
24/4/2024,-9.96,SQ *HEY MR.DUTTON PARK Dutton Park AU,1260.12
24/4/2024,-18.95,DBS*Fitness Cartel Asp Aspley QL AUS Card xx4604 Value Date: 22/04/2024,1270.08
24/4/2024,-5.4,7-ELEVEN 4166 ASPLEY QL AUS Card xx4604 Value Date: 21/04/2024,1289.03
24/4/2024,-6.2,FOSTER & BLACK P/L CHERMSIDE QL AUS Card xx4604 Value Date: 20/04/2024,1294.43
23/4/2024,-19.31,SQ *HEY MR.DUTTON PARK Dutton Park AU,1300.63
23/4/2024,-5.08,SQ *HEY MR.DUTTON PARK Dutton Park AU,1319.94
23/4/2024,-6.3,TRANSLINK BRISBANE AUS Card xx4604 Value Date: 18/04/2024,1325.02
23/4/2024,-6.3,CARSELDINE STATION CARSELDINE AUS Card xx4604 Value Date: 18/04/2024,1331.32
23/4/2024,-6.7,MEKONG CHERMSIDE Chermside QL AUS Card xx4604 Value Date: 20/04/2024,1337.62
23/4/2024,-6.97,H2 AUSTRALIA PTY LTD CHERMSIDE QL AUS Card xx4604 Value Date: 21/04/2024,1344.32
23/4/2024,-8.13,SQ *HEY MR.DUTTON PARK Dutton Park AU,1351.29
22/4/2024,-17.18,SQ *HEY MR.DUTTON PARK Dutton Park AU,1359.42
22/4/2024,-10.09,SQ *BRISBEAN COFFEE Alderley AU,1376.6
20/4/2024,-10.81,YO CHI ALBERT ST BRISBANE ADEL QL AUS Card xx4604 Value Date: 18/04/2024,1386.69
20/4/2024,-14.17,UQU Main Refectory St Lucia QL AUS Card xx4604 Value Date: 18/04/2024,1397.5
20/4/2024,-12.5,Marketcart Herston AU AUS Card xx4604 Value Date: 18/04/2024,1411.67
20/4/2024,-25,MED*ALDIMobile CHATSWOOD AU AUS Card xx4604 Value Date: 18/04/2024,1424.17
19/4/2024,-18.99,Boondall Cellars Boondall AU,1449.17
19/4/2024,-16.9,VIETS ROLL STREET FOOD WOOLLOONGABBAAU,1468.16
19/4/2024,-9.96,SQ *HEY MR.DUTTON PARK Dutton Park AU,1485.06
19/4/2024,-12.11,SQ *BRISBEAN COFFEE Alderley AU,1495.02
19/4/2024,-15,COLES 4670 ASPLEY AU AUS Card xx4604 Value Date: 17/04/2024,1507.13
19/4/2024,-31,KMART 1218 ASPLEY AU AUS Card xx4604 Value Date: 17/04/2024,1522.13
19/4/2024,-3,FITNESS CARTEL ASPLE ASPLEY QL AUS Card xx4604 Value Date: 17/04/2024,1553.13
19/4/2024,-9.5,SMP*Cafe 63 Chermside Chermside AU AUS Card xx4604 Value Date: 17/04/2024,1556.13
19/4/2024,-309,BCC INFRINGEMENTS BRISBANE AUS Card xx4604 Value Date: 18/04/2024,1565.63
18/4/2024,-27,Urban Climb West End West End AU AUS Card xx4604 Value Date: 16/04/2024,1874.63
18/4/2024,-30,TARGET 5184 BRISBANE AU AUS Card xx4604 Value Date: 16/04/2024,1901.63
17/4/2024,699.25,Salary Q GROUP 16042024VAND,1931.63
17/4/2024,-8,BPCN CABO STH 1677 CABOOLTURE QL AUS Card xx4604 Value Date: 14/04/2024,1232.38
17/4/2024,-104.48,BP CON CABLTR NTH 1672 CABOOLTURE QL AUS Card xx4604 Value Date: 12/04/2024,1240.38
17/4/2024,-18.95,DBS*Fitness Cartel Asp Aspley QL AUS Card xx4604 Value Date: 15/04/2024,1344.86
17/4/2024,-119.98,CARSELDINE CELLARS CARSELDINE AUS Card xx4604 Value Date: 12/04/2024,1363.81
16/4/2024,-4.5,Krispy Kreme Albert St 131 Queen StrAU,1483.79
16/4/2024,-19.18,MONG THO TRAN PTY LT BRISBANE CITYQLDAU,1488.29
16/4/2024,-9.66,SQ *HEY MR.DUTTON PARK Dutton Park AU,1507.47
16/4/2024,-35,SQ *JUNGLE LOVE FESTIV Enoggera QL AUS Card xx4604 Value Date: 12/04/2024,1517.13
16/4/2024,-18.65,KFC CABOOLTURE NTH CABOOLTURE QL AUS Card xx4604 Value Date: 12/04/2024,1552.13
15/4/2024,50,Fast Transfer From MR MELVIN JAMES DAYAG Essential supplies Essential supplies,1570.78
15/4/2024,-9.66,SQ *HEY MR.DUTTON PARK Dutton Park AU,1520.78
15/4/2024,-10.09,SQ *BRISBEAN COFFEE Alderley AU,1530.44
14/4/2024,-12.95,MCDONALDS BP CABOOLTU BURPENGARY QLDAU,1540.53
13/4/2024,-5.4,BOOKMARK CAFE ST LUCIA QL AUS Card xx4604 Value Date: 11/04/2024,1553.48
13/4/2024,-9.6,UQU Main Refectory St Lucia QL AUS Card xx4604 Value Date: 11/04/2024,1558.88
13/4/2024,-28.85,LS YKC Investment Trus Brisbane City AU AUS Card xx4604 Value Date: 11/04/2024,1568.48
13/4/2024,-12.81,YO CHI ALBERT ST BRISBANE ADEL QL AUS Card xx4604 Value Date: 11/04/2024,1597.33
12/4/2024,-6.2,BP CON CABLTR NTH 1 CABOOLTURE AU,1610.14
12/4/2024,-5.08,SQ *HEY MR.DUTTON PARK Dutton Park AU,1616.34
11/4/2024,-19.18,MONG THO TRAN PTY LT BRISBANE CITYQLDAU,1621.42
11/4/2024,-5.7,STARBUCKS COFFEE D00 BRISBANE AU,1640.6
11/4/2024,-26,CASSIS AUSTRALIA PTY L WOOLLOONGABBA AU AUS Card xx4604 Value Date: 09/04/2024,1646.3
10/4/2024,900,Salary Q GROUP 09042024VAND,1672.3
10/4/2024,388.75,Salary HSW Group Servic 46097/04/2024,772.3
10/4/2024,-13.25,MCDONALDS ASPLEY ASPLEY QLDAU,383.55
10/4/2024,-6.64,TCC Everton Hills Everton Hills QL AUS Card xx4604 Value Date: 07/04/2024,396.8
10/4/2024,-18.95,DBS*Fitness Cartel Asp Aspley QL AUS Card xx4604 Value Date: 08/04/2024,403.44
10/4/2024,-11.4,JCT QUEENSLAND P/L BRISBANE AUS Card xx4604 Value Date: 05/04/2024,422.39
9/4/2024,-15.96,Thai Street Kitchen Brisbane QL AUS Card xx4604 Value Date: 05/04/2024,433.79
9/4/2024,-7,7-ELEVEN 4084 BRISBANE QL AUS Card xx4604 Value Date: 04/04/2024,449.75
9/4/2024,-10.3,SUSHI HUB ALBERT ST BRISBANE CITY QL AUS Card xx4604 Value Date: 04/04/2024,456.75
9/4/2024,-6.64,TCC Everton Hills Everton Hills QL AUS Card xx4604 Value Date: 06/04/2024,467.05
9/4/2024,-30,TRANSLINK BRISBANE AUS Card xx4604 Value Date: 08/04/2024,473.69
9/4/2024,-10.09,SQ *BRISBEAN COFFEE Alderley AU,503.69
8/4/2024,-18,VIETS ROLL STREET FOOD WOOLLOONGABBAAU,513.78
8/4/2024,-2.54,SQ *HEY MR.DUTTON PARK Dutton Park AU,531.78
8/4/2024,-11.15,SQ *HEY MR.DUTTON PARK Dutton Park AU,534.32
6/4/2024,-4.5,MRS BROWN'S BAR & KIT Newstead AU,545.47
6/4/2024,-29,MRS BROWN'S BAR & KIT Newstead AU,549.97
6/4/2024,-7.98,GZ BLUE PTY LTD BRISBANE CITY AUS Card xx4604 Value Date: 03/04/2024,578.97
5/4/2024,-2.5,TARGET 5184 BRISBANE AU,586.95
5/4/2024,5.59,Refund Purchase SQ *HEY MR.DUTTON PARK Dutton Park AU,589.45
5/4/2024,-10.16,SQ *HEY MR.DUTTON PARK Dutton Park AU,583.86
5/4/2024,-5.59,SQ *HEY MR.DUTTON PARK Dutton Park AU,594.02
5/4/2024,-30,TARGET 5184 BRISBANE AU AUS Card xx4604 Value Date: 03/04/2024,599.61
5/4/2024,-17,VIETS ROLL STREET FOOD WOOLLOONGABBA AUS Card xx4604 Value Date: 03/04/2024,629.61
4/4/2024,-13,LAKESIDE ENTERPRISES UNIVERSITY OFAU Card xx4604,646.61
4/4/2024,-18.95,DBS*Fitness Cartel Asp Aspley QL AUS Card xx4604 Value Date: 02/04/2024,659.61
4/4/2024,-34.93,LS YKC Investment Trus Brisbane City AU AUS Card xx4604 Value Date: 02/04/2024,678.56
3/4/2024,278,Salary Q GROUP 02042024VAND,713.49
3/4/2024,-12.2,SQ *RICE AND MEE Brisbane City AU,435.49
3/4/2024,-71.49,Dominos Estore Carseld dominos.com.a AU AUS Card xx4604 Value Date: 28/03/2024,447.69
3/4/2024,-56.43,CHEMIST WAREHOUSE CHERMSIDE QL AUS Card xx4604 Value Date: 27/03/2024,519.18
3/4/2024,-10.17,YO CHI ALBERT ST BRISBANE ADEL QL AUS Card xx4604 Value Date: 28/03/2024,575.61
3/4/2024,-3.5,COLES EXPRESS 1775 ASPLEY AU AUS Card xx4604 Value Date: 27/03/2024,585.78
3/4/2024,-12.55,8TH MCDOWALL CAFE PTY MCDOWALL AU AUS Card xx4604 Value Date: 29/03/2024,589.28
3/4/2024,-5.9,BAR MERLO UQ BRISBANE QL AUS Card xx4604 Value Date: 28/03/2024,601.83
3/4/2024,-16.83,HOWARDSMITHWHARV* ME&U BRISBANE CITY QL AUS Card xx4604 Value Date: 30/03/2024,607.73
3/4/2024,-3,7 ELEVEN 4229 EVERTON HILLS QL AUS Card xx4604 Value Date: 30/03/2024,624.56
3/4/2024,-10.32,TCC Everton Hills Everton Hills QL AUS Card xx4604 Value Date: 30/03/2024,627.56
3/4/2024,-33.93,SMP*Cafe 63 Chermside Chermside AU AUS Card xx4604 Value Date: 31/03/2024,637.88
3/4/2024,-26.21,DD *DOORDASH HAKATAYAR MELBOURNE VI AUS Card xx4604 Value Date: 31/03/2024,671.81
3/4/2024,-67.96,FITNESS CARTEL ASPLE ASPLEY QL AUS Card xx4604 Value Date: 29/03/2024,698.02
3/4/2024,-8.36,YO GET IT QLD CHERMSIDE QL AUS Card xx4604 Value Date: 31/03/2024,765.98
3/4/2024,25,Return Tickets*EWB UQ x Q BELROSE AU AUS Card xx4604 Value Date: 28/03/2024,774.34
3/4/2024,-15.04,SQ *HEY MR.DUTTON PARK Dutton Park AU,749.34
1/4/2024,-20.58,Guzman y Gomez ACD Albany Creek AU,764.38
30/3/2024,-1,The Trustee for AEK HS Brisbane CQLDAU,784.96
30/3/2024,-3.2,The Trustee for AEK HS Brisbane CQLDAU,785.96
29/3/2024,-15.9,MEKONG 2 CHINESE AND V CHERMSIDE AU AUS Card xx4604 Value Date: 27/03/2024,789.16
28/3/2024,-8,LAKESIDE ENTERPRISES UNIVERSITY OFAU Card xx4604,805.06
28/3/2024,-0.36,7-ELEVEN 4166 ASPLEY QL AUS Card xx4604 Value Date: 25/03/2024,813.06
28/3/2024,-11.68,CellOPark Australia Matraville NS AUS Card xx4604 Value Date: 26/03/2024,813.42
27/3/2024,671.5,Salary Q GROUP 26032024VAND,825.1
27/3/2024,-5,MCDONALDS ASPLEY ASPLEY QLDAU,153.6
27/3/2024,-295,KARL HEINZ RODINS CHERMSIDE QLD AU Card xx4604,158.6
27/3/2024,400,Transfer from xx3679 CommBank app,453.6
27/3/2024,-27,CASSIS AUSTRALIA PTY L WOOLLOONGABBA AU AUS Card xx4604 Value Date: 25/03/2024,53.6
27/3/2024,-5,QUT PARKING KELVIN GROVE QL AUS Card xx4604 Value Date: 24/03/2024,80.6
27/3/2024,-18.95,DBS*Fitness Cartel Asp Aspley QL AUS Card xx4604 Value Date: 25/03/2024,85.6
27/3/2024,-19.18,MONG THO TRAN PTY LT BRISBANE CITY QL AUS Card xx4604 Value Date: 22/03/2024,104.55
26/3/2024,-26,VIETS ROLL STREET FOOD WOOLLOONGABBAAU,123.73
26/3/2024,-10.73,YO CHI ALBERT ST BRISBANE ADEL QL AUS Card xx4604 Value Date: 22/03/2024,149.73
26/3/2024,-6.64,TCC Everton Hills Everton Hills QL AUS Card xx4604 Value Date: 21/03/2024,160.46
26/3/2024,-5.4,7-ELEVEN 4098 ASPLEY QL AUS Card xx4604 Value Date: 22/03/2024,167.1
26/3/2024,-17.5,7 ELEVEN VIRGINIA 42 VIRGINIA QL AUS Card xx4604 Value Date: 23/03/2024,172.5
26/3/2024,-6.64,TCC Everton Hills Everton Hills QL AUS Card xx4604 Value Date: 23/03/2024,190
26/3/2024,-5,SMP*Cafe 63 Chermside Chermside AU AUS Card xx4604 Value Date: 24/03/2024,196.64
26/3/2024,-30,TRANSLINK BRISBANE AUS Card xx4604 Value Date: 25/03/2024,201.64
23/3/2024,-3.5,COLES EXPRESS 1775 ASPLEY AU AUS Card xx4604 Value Date: 20/03/2024,231.64
22/3/2024,-16.77,SQ *HEY MR.DUTTON PARK Dutton Park AU,235.14
22/3/2024,-5.1,8TH MCDOWALL CAFE PTY MCDOWALL AU AUS Card xx4604 Value Date: 20/03/2024,251.91
21/3/2024,80,Transfer from xx3679 CommBank app,257.01
21/3/2024,-580,Transfer to xx3679 CommBank app,177.01
21/3/2024,-10.99,CHEMIST WAREHOUSE UPPE BRISBANE QL AUS Card xx4604 Value Date: 18/03/2024,757.01
21/3/2024,-11.4,CHEZ NOUS CAFE BRISBANE QL AUS Card xx4604 Value Date: 19/03/2024,768
20/3/2024,726,Salary Q GROUP 19032024VAND,779.4
20/3/2024,-3.8,DRAKE SUPERMARKETS M MCDOWALL AU,53.4
20/3/2024,-4.65,WOOLWORTHS 2596 BRISBANE AU AUS Card xx4604 Value Date: 18/03/2024,57.2
20/3/2024,-4.5,HATO GYOZA AND GRILL BRISBANE CITY QL AUS Card xx4604 Value Date: 15/03/2024,61.85
20/3/2024,-24.9,HATO GYOZA AND GRILL BRISBANE CITY QL AUS Card xx4604 Value Date: 15/03/2024,66.35
20/3/2024,-18.95,DBS*Fitness Cartel Asp Aspley QL AUS Card xx4604 Value Date: 18/03/2024,91.25
19/3/2024,-18,VIETS ROLL STREET FOOD WOOLLOONGABBAAU,110.2
19/3/2024,-9.77,YO CHI ALBERT ST BRISBANE ADEL QL AUS Card xx4604 Value Date: 15/03/2024,128.2
19/3/2024,-18.5,KRUSTY KRAB SEAFOODS MCDOWALL QL AUS Card xx4604 Value Date: 14/03/2024,137.97
19/3/2024,-16.81,SQ *MILK & FROTH ASPLE Aspley QL AUS Card xx4604 Value Date: 16/03/2024,156.47
19/3/2024,-21.5,DAMON RHYS LAMB ASPLEY AUS Card xx4604 Value Date: 16/03/2024,173.28
19/3/2024,-25,MED*ALDIMobile CHATSWOOD AU AUS Card xx4604 Value Date: 18/03/2024,194.78
19/3/2024,5.6,Return SQ *MILK & FROTH ASPLE Aspley QL AUS Card xx4604 Value Date: 16/03/2024,219.78
19/3/2024,-302.2,SPER QLD TREASURY BRISBANE AUS Card xx4604 Value Date: 15/03/2024,214.18
19/3/2024,-12,SECURE PARKING VALLEY FORTITUDE VAL AUS Card xx4604 Value Date: 16/03/2024,516.38
18/3/2024,-21.75,SQ *HEY MR.DUTTON PARK Dutton Park AU,528.38
18/3/2024,100,Transfer from xx3679 CommBank app,550.13
16/3/2024,10,Fast Transfer From K TRUONG Burrito,450.13
16/3/2024,-25.5,Guzman y Gomez Bowen Hills AU,440.13
16/3/2024,-12.2,SQ *SUMMA HOUSE PTY LT Fortitude Val AU,465.63
16/3/2024,-47.25,HSW Events Brisbane AU,477.83
16/3/2024,-6.5,HSW Events Brisbane AU,525.08
16/3/2024,-22.81,ZLR*Dominos Pizza Hamil Hamilton AU,531.58
16/3/2024,-5.5,SenseOfTaste Hamilton Hamilton AU,554.39
16/3/2024,-6.55,KFC ASPLEY ASPLEY QL AUS Card xx4604 Value Date: 13/03/2024,559.89
16/3/2024,-6.64,TCC Everton Hills Everton Hills QL AUS Card xx4604 Value Date: 13/03/2024,566.44
15/3/2024,300,Transfer from xx3679 CommBank app,573.08
14/3/2024,-300,Transfer to xx3679 CommBank app,273.08
14/3/2024,-183,GRIFFIN PHYSIO & PILAT WARNER QL AUS Card xx4604 Value Date: 12/03/2024,573.08
14/3/2024,-5.4,7-ELEVEN 4166 ASPLEY QL AUS Card xx4604 Value Date: 11/03/2024,756.08
13/3/2024,507,Salary Q GROUP 12032024VAND,761.48
13/3/2024,-100,Transfer to xx3679 CommBank app,254.48
13/3/2024,150,Fast Transfer From LOURDES VAN DER NEUT Shoes,354.48
13/3/2024,-14.6,TCC Everton Hills Everton Hills QL AUS Card xx4604 Value Date: 10/03/2024,204.48
13/3/2024,-18.95,DBS*Fitness Cartel Asp Aspley QL AUS Card xx4604 Value Date: 11/03/2024,219.08
12/3/2024,100,Transfer from xx3679 CommBank app,238.03
12/3/2024,-12.52,KENKO SUSHI HOUSE ST LUCIA AU AUS Card xx4604 Value Date: 08/03/2024,138.03
12/3/2024,-5.08,SQ *HEY MR.DUTTON PARK Dutton Park QL AUS Card xx4604 Value Date: 08/03/2024,150.55
12/3/2024,-26.13,Tickets*EWB UQ x Q BELROSE AU AUS Card xx4604 Value Date: 08/03/2024,155.63
11/3/2024,100,Transfer from xx3679 CommBank app,181.76
11/3/2024,-11,Boost Albert Street Brisbane AU,81.76
9/3/2024,-16.95,KFC Hamilton AU AUS Card xx4604 Value Date: 07/03/2024,92.76
9/3/2024,-10.7,OOBI GROUP PTY LTD ST LUCIA QL AUS Card xx4604 Value Date: 07/03/2024,109.71
9/3/2024,-124.9,Pin* TicketsThe Partic Burnside AUS Card xx4604 Value Date: 07/03/2024,120.41
9/3/2024,-33.9,DBS*Fitness Cartel Asp Aspley QL AUS Card xx4604 Value Date: 07/03/2024,245.31
9/3/2024,-30,TRANSLINK BRISBANE AUS Card xx4604 Value Date: 07/03/2024,279.21
8/3/2024,-4.06,UQU Bakery St Lucia AU,309.21
8/3/2024,-40,TARGET 5184 BRISBANE AU AUS Card xx4604 Value Date: 06/03/2024,313.27
8/3/2024,-11,Boost Albert Street Brisbane QL AUS Card xx4604 Value Date: 06/03/2024,353.27
7/3/2024,150,Transfer from xx3679 CommBank app,364.27
6/3/2024,-450,Transfer to xx3679 CommBank app,214.27
6/3/2024,608,Salary Q GROUP 05032024VAND,664.27
6/3/2024,50,Transfer from xx3679 CommBank app,56.27
6/3/2024,-10.33,YO CHI PADDINGTON PADDINGTON QL AUS Card xx4604 Value Date: 02/03/2024,6.27
6/3/2024,-13.3,SUSHI HUB ALBERT ST BRISBANE CITY QL AUS Card xx4604 Value Date: 01/03/2024,16.6
5/3/2024,-17.18,SQ *HEY MR.DUTTON PARK Dutton Park AU,29.9
5/3/2024,-10.37,SQ *HEY MR.DUTTON PARK Dutton Park AU,47.08
5/3/2024,-15.23,TS/NEWMARKET VILLAGE BRISBANE QL AUS Card xx4604 Value Date: 01/03/2024,57.45
5/3/2024,-687,RMWilliams Queen St Brisbane AU AUS Card xx4604 Value Date: 01/03/2024,72.68
5/3/2024,-7.98,GZ BLUE PTY LTD BRISBANE CITY AUS Card xx4604 Value Date: 29/02/2024,759.68
5/3/2024,-33.05,DRAKE SUPERMARKETS M MCDOWALL AUS Card xx4604 Value Date: 29/02/2024,767.66
5/3/2024,-23.88,BROKENHEARTSBURGERCLUB BRISBANE QL AUS Card xx4604 Value Date: 02/03/2024,800.71
5/3/2024,-5.1,8TH MCDOWALL CAFE PTY MCDOWALL AU AUS Card xx4604 Value Date: 03/03/2024,824.59
4/3/2024,-16.9,VIETS ROLL STREET FOOD WOOLLOONGABBAAU,829.69
4/3/2024,50,Transfer from xx3679 CommBank app,846.59
2/3/2024,-64,StepPay Repayment,796.59
2/3/2024,100,Transfer from xx3679 CommBank app,860.59
2/3/2024,-5.1,8TH MCDOWALL CAFE PTY MCDOWALL AU AUS Card xx4604 Value Date: 29/02/2024,760.59
2/3/2024,-10.7,OOBI GROUP PTY LTD ST LUCIA QL AUS Card xx4604 Value Date: 29/02/2024,765.69
2/3/2024,-3.7,CantaloupeSystemsAustr Albion QL AUS Card xx4604 Value Date: 29/02/2024,776.39
2/3/2024,-75.96,CALTEX EVERTON PARK EVERTON PARK AUS Card xx4604 Value Date: 28/02/2024,780.09
1/3/2024,41,Transfer from xx3679 CommBank app,856.05
1/3/2024,-16.5,Transfer To Angus McHugh CommBank App Movie - Jacob,815.05
1/3/2024,-5.9,CantaloupeSystemsAustr Albion QL AUS Card xx4604 Value Date: 28/02/2024,831.55
1/3/2024,-9.6,UQU Main Refectory St Lucia QL AUS Card xx4604 Value Date: 28/02/2024,837.45
1/3/2024,-84.92,McDowall Village Medi McDowall QL AUS Card xx4604 Value Date: 29/02/2024,847.05
29/2/2024,41.4,Refund Purchase Medicare Benefit,931.97
29/2/2024,-19.9,VIETS ROLL STREET FOOD WOOLLOONGABBA AUS Card xx4604 Value Date: 27/02/2024,890.57
28/2/2024,608,Salary Q GROUP 27022024VAND,910.47
28/2/2024,-10,WOOLWORTHS 2596 BRISBANE AU AUS Card xx4604 Value Date: 26/02/2024,302.47
28/2/2024,-14.95,KFC Hamilton AU AUS Card xx4604 Value Date: 26/02/2024,312.47
28/2/2024,-4.78,SQ *HEY MR.DUTTON PARK Dutton Park QL AUS Card xx4604 Value Date: 26/02/2024,327.42
28/2/2024,-18.95,DBS*Fitness Cartel Asp Aspley QL AUS Card xx4604 Value Date: 26/02/2024,332.2
28/2/2024,-3.98,CellOPark Australia Matraville NS AUS Card xx4604 Value Date: 26/02/2024,351.15
28/2/2024,-5,AUSTRALIAN CRAWL PL FITZGIBBON QL AUS Card xx4604 Value Date: 24/02/2024,355.13
28/2/2024,-30,TRANSLINK BRISBANE AUS Card xx4604 Value Date: 26/02/2024,360.13
27/2/2024,-7,CASSIS AUSTRALIA PTY L WOOLLOONGABBA AU AUS Card xx4604 Value Date: 23/02/2024,390.13
27/2/2024,-12,CASSIS AUSTRALIA PTY L WOOLLOONGABBA AU AUS Card xx4604 Value Date: 23/02/2024,397.13
27/2/2024,-8,7-ELEVEN 4166 ASPLEY QL AUS Card xx4604 Value Date: 22/02/2024,409.13
27/2/2024,-5.4,7-ELEVEN 4098 ASPLEY QL AUS Card xx4604 Value Date: 23/02/2024,417.13
27/2/2024,-5.5,BCC CELLOPARK ON-STREE BRISBANE AUS Card xx4604 Value Date: 26/02/2024,422.53
24/2/2024,-30.1,sAmesAme Fortitude ValAU,428.03
24/2/2024,-31.98,AMAZON AU MARKETPLACE SYDNEY AUS Card xx4604 Value Date: 21/02/2024,458.13
23/2/2024,-17.9,VIETS ROLL STREET FOOD WOOLLOONGABBAAU,490.11
23/2/2024,-10.7,OOBI GROUP PTY LTD ST LUCIA QL AUS Card xx4604 Value Date: 21/02/2024,508.01
23/2/2024,-11.1,7-ELEVEN 4098 ASPLEY QL AUS Card xx4604 Value Date: 21/02/2024,518.71
23/2/2024,-11.9,EB *Kickstart your Car 801-413-7200 VI AUS Card xx4604 Value Date: 21/02/2024,529.81
23/2/2024,-14.17,UQU Main Refectory St Lucia QL AUS Card xx4604 Value Date: 21/02/2024,541.71
23/2/2024,-2.43,UQU Lollyshop St Lucia QL AUS Card xx4604 Value Date: 21/02/2024,555.88
23/2/2024,-13,LAKESIDE ENTERPRISEQPS UNIVERSITY OF AUS Card xx4604 Value Date: 21/02/2024,558.31
22/2/2024,-549,DANNYS DESKS AND CHAIRS B STAFFOR QLD AU Card xx4604,571.31
22/2/2024,-4.65,WOOLWORTHS 2583 STAFFORD AU AUS Card xx4604 Value Date: 20/02/2024,1120.31
22/2/2024,-21.95,SQ *HEY MR.DUTTON PARK Dutton Park QL AUS Card xx4604 Value Date: 20/02/2024,1124.96
21/2/2024,608,Salary Q GROUP 20022024VAND,1146.91
21/2/2024,-13.41,EATONS HILL HOTEL EATONS HILL AU AUS Card xx4604 Value Date: 18/02/2024,538.91
21/2/2024,-25.7,COLLINS RESTAURANTS UNDERWOOD QL AUS Card xx4604 Value Date: 18/02/2024,552.32
21/2/2024,-7.5,BP UNDERWOOD SOUTH 111 UNDERWOOD QL AUS Card xx4604 Value Date: 18/02/2024,578.02
21/2/2024,-18.95,DBS*Fitness Cartel Asp Aspley QL AUS Card xx4604 Value Date: 19/02/2024,585.52
21/2/2024,-18.17,MONG THO TRAN PTY LT BRISBANE CITY QL AUS Card xx4604 Value Date: 16/02/2024,604.47
20/2/2024,-109.95,UNIVERSAL STORE BRISBANE QL AUS Card xx4604 Value Date: 16/02/2024,622.64
20/2/2024,-19.5,La Carmela Petrie Terrac QL AUS Card xx4604 Value Date: 16/02/2024,732.59
20/2/2024,-20,BRAVO FIT CHERMSIDE CHERMSIDE QL AUS Card xx4604 Value Date: 17/02/2024,752.09
20/2/2024,-6.65,WOOLWORTHS 2673 CHERMSIDE AU AUS Card xx4604 Value Date: 17/02/2024,772.09
20/2/2024,-3.6,COLES 4334 BRISBANE AU AUS Card xx4604 Value Date: 16/02/2024,778.74
20/2/2024,-21,SMP*Cafe 63 Chermside Chermside AU AUS Card xx4604 Value Date: 17/02/2024,782.34
20/2/2024,-383,99 Bikes Everton Park Everton Park QL AUS Card xx4604 Value Date: 18/02/2024,803.34
19/2/2024,266.49,Direct Credit 141000 SIGNMANAGER PTY WEEKLY PAYROLL,1186.34
19/2/2024,-25.9,VIETS ROLL STREET FOOD WOOLLOONGABBAAU,919.85
19/2/2024,-30,Transfer To Harry Dorreboom CommBank App Groceries,945.75
17/2/2024,-20,AUST ELECTORAL COMM SYDNEY NS AUS Card xx4604 Value Date: 14/02/2024,975.75
17/2/2024,-25,MED*ALDIMobile CHATSWOOD AU AUS Card xx4604 Value Date: 16/02/2024,995.75
17/2/2024,-17.9,VIETS ROLL STREET FOOD WOOLLOONGABBA AUS Card xx4604 Value Date: 15/02/2024,1020.75
16/2/2024,-8.5,Krispy Kreme Albert St 131 Queen StrAU,1038.65
16/2/2024,118,Direct Credit 364049 Q ELECTRICAL SER 31074247,1047.15
16/2/2024,544.32,Direct Credit 141000 SIGNMANAGER PTY WEEKLY PAYROLL,929.15
16/2/2024,-3.9,COLES 4461 BRISBANE AU,384.83
16/2/2024,-5.2,LCM INVESTMENT GROUP P PETRIE TERRACAU,388.73
16/2/2024,-26,WWW.LACARMELA.COM.AU PETRIE TERRAC QL AUS Card xx4604 Value Date: 14/02/2024,393.93
16/2/2024,-3.6,COLES 4461 BRISBANE AU AUS Card xx4604 Value Date: 14/02/2024,419.93
16/2/2024,-30,TRANSLINK BRISBANE AUS Card xx4604 Value Date: 15/02/2024,423.53
15/2/2024,-5.59,SQ *HEY MR.DUTTON PARK Dutton Park AU,453.53
14/2/2024,427,Salary Q GROUP 13022024VAND,459.12
14/2/2024,-4.9,LCM INVESTMENT GROUP P PETRIE TERRACAU,32.12
14/2/2024,-18.95,DBS*Fitness Cartel Asp Aspley QL AUS Card xx4604 Value Date: 12/02/2024,37.02
14/2/2024,-57.39,COLES 4547 CHERMSIDE AU AUS Card xx4604 Value Date: 12/02/2024,55.97
13/2/2024,-60,SPER QLD TREASURY BRISBANE AUS Card xx4604 Value Date: 09/02/2024,113.36
10/2/2024,-7.99,AMAZON AU MARKETPLACE SYDNEY AUS Card xx4604 Value Date: 08/02/2024,173.36
9/2/2024,-13,99 Bikes Everton Park Everton Park AU,181.35
9/2/2024,-970,Transfer to xx3679 CommBank app,194.35
9/2/2024,119,Direct Credit 364049 Q ELECTRICAL SER 31074231,1164.35
9/2/2024,724.18,Direct Credit 141000 SIGNMANAGER PTY WEEKLY PAYROLL,1045.35
9/2/2024,-3.6,COLES 4461 BRISBANE AU,321.17
9/2/2024,-7.9,LCM INVESTMENT GROUP P PETRIE TERRACAU,324.77
9/2/2024,-4.9,LCM INVESTMENT GROUP P PETRIE TERRACAU,332.67
9/2/2024,-35.25,JUST JEANS BRISBANE AUS Card xx4604 Value Date: 07/02/2024,337.57
8/2/2024,-9.76,SQ *HEY MR.DUTTON PARK Dutton Park AU,372.82
8/2/2024,-27,CASSIS AUSTRALIA PTY L WOOLLOONGABBA AU AUS Card xx4604 Value Date: 06/02/2024,382.58
7/2/2024,-1000,Transfer to xx3679 CommBank app,409.58
7/2/2024,-19.5,Roll'd Brisbane AU,1409.58
7/2/2024,562.5,Salary Q GROUP 06022024VAND,1429.08
7/2/2024,-3.6,COLES 4461 BRISBANE AU,866.58
7/2/2024,-5.2,LCM INVESTMENT GROUP P PETRIE TERRACAU,870.18
7/2/2024,-13.6,Mitsuki Sushi Brisbane AU AUS Card xx4604 Value Date: 05/02/2024,875.38
7/2/2024,-5.4,7-ELEVEN 4062 BRISBANE QL AUS Card xx4604 Value Date: 05/02/2024,888.98
7/2/2024,-10.36,YO GET IT QLD CHERMSIDE QL AUS Card xx4604 Value Date: 04/02/2024,894.38
7/2/2024,-18.95,DBS*Fitness Cartel Asp Aspley QL AUS Card xx4604 Value Date: 05/02/2024,904.74
7/2/2024,-13.85,MCDONALDS NEWMARKET 2 NEWMARKET AUS Card xx4604 Value Date: 03/02/2024,923.69
7/2/2024,-30,TRANSLINK BRISBANE AUS Card xx4604 Value Date: 05/02/2024,937.54
6/2/2024,-18.9,MEKONG CHERMSIDE Chermside QL AUS Card xx4604 Value Date: 04/02/2024,967.54
5/2/2024,-48,YGK FAMILY PTY LTD QLDQLDAU,986.44
5/2/2024,-9.96,SQ *HEY MR.DUTTON PARK Dutton Park AU,1034.44
3/2/2024,-12,CASSIS AUSTRALIA PTY L WOOLLOONGABBA AU AUS Card xx4604 Value Date: 01/02/2024,1044.4
3/2/2024,-115.25,7-ELEVEN 4098 ASPLEY QL AUS Card xx4604 Value Date: 01/02/2024,1056.4
3/2/2024,-15.9,VIETS ROLL STREET FOOD WOOLLOONGABBA AUS Card xx4604 Value Date: 01/02/2024,1171.65
2/2/2024,622.02,Direct Credit 141000 SIGNMANAGER PTY WEEKLY PAYROLL,1187.55
2/2/2024,2.16,Transfer from xx1526 CommBank app,565.53
2/2/2024,-1000,Transfer to xx3679 CommBank app,563.37
2/2/2024,-4.65,COLES 4461 BRISBANE AU,1563.37
2/2/2024,-15.5,La Carmela Petrie TerracAU,1568.02
2/2/2024,-4.9,LCM INVESTMENT GROUP P PETRIE TERRACAU,1583.52
2/2/2024,-13.65,WATERLOO HOTEL APP Newstead QL AUS Card xx4604 Value Date: 31/01/2024,1588.42
2/2/2024,-21,The Pass - Waterloo H Collinswood QL AUS Card xx4604 Value Date: 31/01/2024,1602.07
1/2/2024,-9.96,SQ *HEY MR.DUTTON PARK Dutton Park AU,1623.07
1/2/2024,-135.27,THAI O SHA PTY LTD ASPLEY AU AUS Card xx4604 Value Date: 30/01/2024,1633.03
31/1/2024,300,Fast Transfer From BRONWYN PERKINS Happy Birthday Jacob,1768.3
31/1/2024,140,Fast Transfer From LOURDES VAN DER NEUT Bday dinner,1468.3
31/1/2024,529.38,Salary Q GROUP 30012024VAND,1328.3